aleksandrowa kujawskiego	aleksandrów kujawski
aleksandrowem kujawskim	aleksandrów kujawski
aleksandrowie kujawski	aleksandrów kujawski
aleksandrowie kujawskim	aleksandrów kujawski
aleksandrowowi kujawskiemu	aleksandrów kujawski
andrychowa	andrychów
andrychowem	andrychów
andrychowie	andrychów
andrychowowi	andrychów
augustowa	augustów
augustowem	augustów
augustowie	augustów
augustowowi	augustów
augustianach	augustianin
augustianami	augustianin
augustianie	augustianin
augustianin	augustianin
augustianina	augustianin
augustianinem	augustianin
augustianinie	augustianin
augustianinowi	augustianin
augustianom	augustianin
augustiance	augustianka
augustianek	augustianka
augustianka	augustianka
augustiankach	augustianka
augustiankami	augustianka
augustianki	augustianka
augustianko	augustianka
augustiankom	augustianka
augustowian	augustowianin
augustowianach	augustowianin
augustowianami	augustowianin
augustowianie	augustowianin
augustowianin	augustowianin
augustowianina	augustowianin
augustowianinem	augustowianin
augustowianinie	augustowianin
augustowianinowi	augustowianin
augustowianom	augustowianin
augustowiance	augustowianka
augustowianek	augustowianka
augustowianka	augustowianka
augustowiankach	augustowianka
augustowiankami	augustowianka
augustowianki	augustowianka
augustowianko	augustowianka
augustowiankom	augustowianka
augustowscy	augustowski
augustowska	augustowski
augustowski	augustowski
augustowskich	augustowski
augustowskie	augustowski
augustowskiego	augustowski
augustowskiej	augustowski
augustowskiemu	augustowski
augustowskim	augustowski
augustowskimi	augustowski
augustyn	augustyn
augustyna	augustyn
augustynach	augustyn
augustynami	augustyn
augustynem	augustyn
augustynie	augustyn
augustynom	augustyn
augustynowi	augustyn
augustynowie	augustyn
augustyniak	augustyniak
augustyniaka	augustyniak
augustyniakach	augustyniak
augustyniakami	augustyniak
augustyniakiem	augustyniak
augustyniakom	augustyniak
augustyniakowi	augustyniak
augustyniakowie	augustyniak
augustyniaku	augustyniak
barlinek	barlinek
barlinka	barlinek
barlinkiem	barlinek
barlinkowi	barlinek
barlinku	barlinek
bartoszewicz	bartoszewicz
bartoszewicza	bartoszewicz
bartoszewiczach	bartoszewicz
bartoszewiczami	bartoszewicz
bartoszewiczem	bartoszewicz
bartoszewiczom	bartoszewicz
bartoszewiczowi	bartoszewicz
bartoszewiczowie	bartoszewicz
bartoszewiczu	bartoszewicz
bartoszewscy	bartoszewski
bartoszewski	bartoszewski
bartoszewskich	bartoszewski
bartoszewskiego	bartoszewski
bartoszewskiemu	bartoszewski
bartoszewskim	bartoszewski
bartoszewskimi	bartoszewski
bartoszyc	bartoszyce
bartoszycach	bartoszyce
bartoszycami	bartoszyce
bartoszyce	bartoszyce
bartoszycom	bartoszyce
bielawa	bielawa
bielawie	bielawa
bielawo	bielawa
bielawy	bielawa
bielawscy	bielawski
bielawska	bielawski
bielawski	bielawski
bielawskich	bielawski
bielawskie	bielawski
bielawskiego	bielawski
bielawskiej	bielawski
bielawskiemu	bielawski
bielawskim	bielawski
bielawskimi	bielawski
biskupach	biskupiec
biskupca	biskupiec
biskupcem	biskupiec
biskupcowi	biskupiec
biskupcu	biskupiec
biskupiec	biskupiec
bochni	bochnia
bochnia	bochnia
bochnio	bochnia
bogatyni	bogatynia
bogatynia	bogatynia
bogatynio	bogatynia
bogatynian	bogatynianin
bogatynianach	bogatynianin
bogatynianami	bogatynianin
bogatynianie	bogatynianin
bogatynianin	bogatynianin
bogatynianina	bogatynianin
bogatynianinem	bogatynianin
bogatynianinie	bogatynianin
bogatynianinowi	bogatynianin
bogatynianom	bogatynianin
bogatyniance	bogatynianka
bogatynianek	bogatynianka
bogatynianka	bogatynianka
bogatyniankach	bogatynianka
bogatyniankami	bogatynianka
bogatynianki	bogatynianka
bogatynianko	bogatynianka
bogatyniankom	bogatynianka
boguszowem-gorcami	boguszów-gorce
boguszowie-gorcach	boguszów-gorce
boguszowie-gorce	boguszów-gorce
boguszowowi-gorcom	boguszów-gorce
boguszowian	boguszowianin
boguszowianach	boguszowianin
boguszowianami	boguszowianin
boguszowianie	boguszowianin
boguszowianin	boguszowianin
boguszowianina	boguszowianin
boguszowianinem	boguszowianin
boguszowianinie	boguszowianin
boguszowianinowi	boguszowianin
boguszowianom	boguszowianin
boguszowiance	boguszowianka
boguszowianek	boguszowianka
boguszowianka	boguszowianka
boguszowiankach	boguszowianka
boguszowiankami	boguszowianka
boguszowianki	boguszowianka
boguszowianko	boguszowianka
boguszowiankom	boguszowianka
bolkowa	bolków
bolkowem	bolków
bolkowie	bolków
bolkowowi	bolków
bolkowian	bolkowianin
bolkowianach	bolkowianin
bolkowianami	bolkowianin
bolkowianie	bolkowianin
bolkowianin	bolkowianin
bolkowianina	bolkowianin
bolkowianinem	bolkowianin
bolkowianinie	bolkowianin
bolkowianinowi	bolkowianin
bolkowianom	bolkowianin
bolkowiance	bolkowianka
bolkowianek	bolkowianka
bolkowianka	bolkowianka
bolkowiankach	bolkowianka
bolkowiankami	bolkowianka
bolkowianki	bolkowianka
bolkowianko	bolkowianka
bolkowiankom	bolkowianka
bolkowscy	bolkowski
bolkowska	bolkowski
bolkowski	bolkowski
bolkowskich	bolkowski
bolkowskie	bolkowski
bolkowskiego	bolkowski
bolkowskiej	bolkowski
bolkowskiemu	bolkowski
bolkowskim	bolkowski
bolkowskimi	bolkowski
braniewa	braniewo
braniewem	braniewo
braniewie	braniewo
braniewo	braniewo
braniewu	braniewo
braniewscy	braniewski
braniewska	braniewski
braniewski	braniewski
braniewskich	braniewski
braniewskie	braniewski
braniewskiego	braniewski
braniewskiej	braniewski
braniewskiemu	braniewski
braniewskim	braniewski
braniewskimi	braniewski
brodnic	brodnica
brodnica	brodnica
brodnicach	brodnica
brodnicami	brodnica
brodnice	brodnica
brodnico	brodnica
brodnicom	brodnica
brodnicy	brodnica
brodniccy	brodnicki
brodnicka	brodnicki
brodnicki	brodnicki
brodnickich	brodnicki
brodnickie	brodnicki
brodnickiego	brodnicki
brodnickiej	brodnicki
brodnickiemu	brodnicki
brodnickim	brodnicki
brodnickimi	brodnicki
brodniccy	brodnicki
brodnicka	brodnicki
brodnicki	brodnicki
brodnickich	brodnicki
brodnickie	brodnicki
brodnickiego	brodnicki
brodnickiej	brodnicki
brodnickiemu	brodnicki
brodnickim	brodnicki
brodnickimi	brodnicki
najbrodniccy	brodnicki
najbrodnicka	brodnicki
najbrodnicki	brodnicki
najbrodnickich	brodnicki
najbrodnickie	brodnicki
najbrodnickiego	brodnicki
najbrodnickiej	brodnicki
najbrodnickiemu	brodnicki
najbrodnickim	brodnicki
najbrodnickimi	brodnicki
brzeg	brzeg
brzeg	brzeg
brzegach	brzeg
brzegami	brzeg
brzegi	brzeg
brzegiem	brzeg
brzegiem	brzeg
brzegom	brzeg
brzegowi	brzeg
brzegowi	brzeg
brzegu	brzeg
brzegu	brzeg
brzeska	brzesko
brzeskiem	brzesko
brzesko	brzesko
brzesku	brzesko
brzeziniak	brzeziniak
brzeziniakach	brzeziniak
brzeziniakami	brzeziniak
brzeziniaki	brzeziniak
brzeziniakiem	brzeziniak
brzeziniakom	brzeziniak
brzeziniakowi	brzeziniak
brzeziniaku	brzeziniak
brzezin	brzeziny
brzezinach	brzeziny
brzezinami	brzeziny
brzezinom	brzeziny
brzeziny	brzeziny
brzozowscy	brzozowski
brzozowski	brzozowski
brzozowskich	brzozowski
brzozowskiego	brzozowski
brzozowskiemu	brzozowski
brzozowskim	brzozowski
brzozowskimi	brzozowski
brzozowy	brzozowy
brzozowych	brzozowy
brzozowym	brzozowy
brzozowymi	brzozowy
buscy	buski
buska	buski
buski	buski
buskich	buski
buskie	buski
buskiego	buski
buskiej	buski
buskiemu	buski
buskim	buski
buskimi	buski
buska-zdroju	busko-zdrój
buskiem-zdrojem	busko-zdrój
busku-zdrojowi	busko-zdrój
busku-zdroju	busko-zdrój
buszczan	buszczanin
buszczanach	buszczanin
buszczanami	buszczanin
buszczanie	buszczanin
buszczanin	buszczanin
buszczanina	buszczanin
buszczaninem	buszczanin
buszczaninie	buszczanin
buszczaninowi	buszczanin
buszczanom	buszczanin
buszczance	buszczanka
buszczanek	buszczanka
buszczanka	buszczanka
buszczankach	buszczanka
buszczankami	buszczanka
buszczanki	buszczanka
buszczanko	buszczanka
buszczankom	buszczanka
bydgoscy	bydgoski
bydgoska	bydgoski
bydgoski	bydgoski
bydgoskich	bydgoski
bydgoskie	bydgoski
bydgoskiego	bydgoski
bydgoskiej	bydgoski
bydgoskiemu	bydgoski
bydgoskim	bydgoski
bydgoskimi	bydgoski
bydgoszcz	bydgoszcz
bydgoszczy	bydgoszcz
bytowa	bytów
bytowem	bytów
bytowie	bytów
bytowu	bytów
bytom	bytom
bytomia	bytom
bytomiem	bytom
bytomiowi	bytom
bytomiu	bytom
bytomian	bytomianin
bytomianach	bytomianin
bytomianami	bytomianin
bytomianie	bytomianin
bytomianin	bytomianin
bytomianina	bytomianin
bytomianinem	bytomianin
bytomianinie	bytomianin
bytomianinowi	bytomianin
bytomianom	bytomianin
bytomiance	bytomianka
bytomianek	bytomianka
bytomianka	bytomianka
bytomiankach	bytomianka
bytomiankami	bytomianka
bytomianki	bytomianka
bytomianko	bytomianka
bytomiankom	bytomianka
bytomscy	bytomski
bytomska	bytomski
bytomski	bytomski
bytomskich	bytomski
bytomskie	bytomski
bytomskiego	bytomski
bytomskiej	bytomski
bytomskiemu	bytomski
bytomskim	bytomski
bytomskimi	bytomski
bytowian	bytowianin
bytowianach	bytowianin
bytowianami	bytowianin
bytowianie	bytowianin
bytowianin	bytowianin
bytowianina	bytowianin
bytowianinem	bytowianin
bytowianinie	bytowianin
bytowianinowi	bytowianin
bytowianom	bytowianin
bytowiance	bytowianka
bytowianek	bytowianka
bytowianka	bytowianka
bytowiankach	bytowianka
bytowiankami	bytowianka
bytowianki	bytowianka
bytowianko	bytowianka
bytowiankom	bytowianka
bytowscy	bytowski
bytowska	bytowski
bytowski	bytowski
bytowskich	bytowski
bytowskie	bytowski
bytowskiego	bytowski
bytowskiej	bytowski
bytowskiemu	bytowski
bytowskim	bytowski
bytowskimi	bytowski
chojnic	chojnice
chojnicach	chojnice
chojnicami	chojnice
chojnice	chojnice
chojnicom	chojnice
chorzowa	chorzów
chorzowem	chorzów
chorzowie	chorzów
chorzowowi	chorzów
chorzowscy	chorzowski
chorzowska	chorzowski
chorzowski	chorzowski
chorzowskich	chorzowski
chorzowskie	chorzowski
chorzowskiego	chorzowski
chorzowskiej	chorzowski
chorzowskiemu	chorzowski
chorzowskim	chorzowski
chorzowskimi	chorzowski
choszcznem	choszczno
choszcznie	choszczno
choszczno	choszczno
choszcznu	choszczno
chrzanowem	chrzanów
chrzanowie	chrzanów
chrzanowscy	chrzanowski
chrzanowska	chrzanowski
chrzanowski	chrzanowski
chrzanowskich	chrzanowski
chrzanowskie	chrzanowski
chrzanowskiego	chrzanowski
chrzanowskiej	chrzanowski
chrzanowskiemu	chrzanowski
chrzanowskim	chrzanowski
chrzanowskimi	chrzanowski
ciech	ciech
ciecha	ciech
ciechach	ciech
ciechami	ciech
ciechem	ciech
ciechom	ciech
ciechowi	ciech
ciechowie	ciech
ciechu	ciech
ciechanowem	ciechanów
ciechanowie	ciechanów
ciechanowscy	ciechanowski
ciechanowska	ciechanowski
ciechanowski	ciechanowski
ciechanowskich	ciechanowski
ciechanowskie	ciechanowski
ciechanowskiego	ciechanowski
ciechanowskiej	ciechanowski
ciechanowskiemu	ciechanowski
ciechanowskim	ciechanowski
ciechanowskimi	ciechanowski
ciechocinek	ciechocinek
ciechocinka	ciechocinek
ciechocinkiem	ciechocinek
ciechocinkowi	ciechocinek
ciechocinku	ciechocinek
cieszyn	cieszyn
cieszyna	cieszyn
cieszynach	cieszyn
cieszynami	cieszyn
cieszynem	cieszyn
cieszynie	cieszyn
cieszynom	cieszyn
cieszynowi	cieszyn
cieszyny	cieszyn
cieszyniaczce	cieszyniaczka
cieszyniaczek	cieszyniaczka
cieszyniaczka	cieszyniaczka
cieszyniaczkach	cieszyniaczka
cieszyniaczkami	cieszyniaczka
cieszyniaczki	cieszyniaczka
cieszyniaczko	cieszyniaczka
cieszyniaczkom	cieszyniaczka
cieszyniacy	cieszyniak
cieszyniak	cieszyniak
cieszyniaka	cieszyniak
cieszyniakach	cieszyniak
cieszyniakami	cieszyniak
cieszyniakiem	cieszyniak
cieszyniakom	cieszyniak
cieszyniakowi	cieszyniak
cieszyniaku	cieszyniak
cieszynian	cieszynianin
cieszynianach	cieszynianin
cieszynianami	cieszynianin
cieszynianie	cieszynianin
cieszynianin	cieszynianin
cieszynianina	cieszynianin
cieszynianinem	cieszynianin
cieszynianinie	cieszynianin
cieszynianinowi	cieszynianin
cieszynianom	cieszynianin
cieszyniance	cieszynianka
cieszynianek	cieszynianka
cieszynianka	cieszynianka
cieszyniankach	cieszynianka
cieszyniankami	cieszynianka
cieszynianki	cieszynianka
cieszynianko	cieszynianka
cieszyniankom	cieszynianka
cieszynicie	cieszynit
cieszynit	cieszynit
cieszynitach	cieszynit
cieszynitami	cieszynit
cieszynitem	cieszynit
cieszynitom	cieszynit
cieszynitowi	cieszynit
cieszynitu	cieszynit
cieszynity	cieszynit
cieszynitowa	cieszynitowy
cieszynitowe	cieszynitowy
cieszynitowego	cieszynitowy
cieszynitowej	cieszynitowy
cieszynitowemu	cieszynitowy
cieszynitowy	cieszynitowy
cieszynitowych	cieszynitowy
cieszynitowym	cieszynitowy
cieszynitowymi	cieszynitowy
cieszynce	cieszynka
cieszynek	cieszynka
cieszynka	cieszynka
cieszynkach	cieszynka
cieszynkami	cieszynka
cieszynki	cieszynka
cieszynko	cieszynka
cieszynkom	cieszynka
czechowicach-dziedzicach	czechowice-dziedzice
czechowicami-dziedzicami	czechowice-dziedzice
czechowic-dziedzic	czechowice-dziedzice
czechowice-dziedzice	czechowice-dziedzice
czechowicom-dziedzicom	czechowice-dziedzice
drezdeneccy	drezdenecki
drezdenecka	drezdenecki
drezdenecki	drezdenecki
drezdeneckich	drezdenecki
drezdeneckie	drezdenecki
drezdeneckiego	drezdenecki
drezdeneckiej	drezdenecki
drezdeneckiemu	drezdenecki
drezdeneckim	drezdenecki
drezdeneckimi	drezdenecki
drezdenka	drezdenko
drezdenkiem	drezdenko
drezdenko	drezdenko
drezdenku	drezdenko
dusznikach-zdroju	duszniki-zdrój
dusznikami-zdrojem	duszniki-zdrój
dusznikom-zdrojowi	duszniki-zdrój
form	forma
forma	forma
formach	forma
formami	forma
formie	forma
formo	forma
formom	forma
formy	forma
garwolin	garwolin
garwolina	garwolin
garwolinem	garwolin
garwolinie	garwolin
garwolinowi	garwolin
gawron	gawron
gawrona	gawron
gawronach	gawron
gawronami	gawron
gawronem	gawron
gawronie	gawron
gawronom	gawron
gawronowi	gawron
gawrony	gawron
gdyni	gdynia
gdynia	gdynia
gdynio	gdynia
gliwic	gliwice
gliwicach	gliwice
gliwicami	gliwice
gliwice	gliwice
gliwicom	gliwice
gliwiccy	gliwicki
gliwicka	gliwicki
gliwicki	gliwicki
gliwickich	gliwicki
gliwickie	gliwicki
gliwickiego	gliwicki
gliwickiej	gliwicki
gliwickiemu	gliwicki
gliwickim	gliwicki
gliwickimi	gliwicki
gliwiccy	gliwicki
gliwicka	gliwicki
gliwicki	gliwicki
gliwickich	gliwicki
gliwickie	gliwicki
gliwickiego	gliwicki
gliwickiej	gliwicki
gliwickiemu	gliwicki
gliwickim	gliwicki
gliwickimi	gliwicki
najgliwiccy	gliwicki
najgliwicka	gliwicki
najgliwicki	gliwicki
najgliwickich	gliwicki
najgliwickie	gliwicki
najgliwickiego	gliwicki
najgliwickiej	gliwicki
najgliwickiemu	gliwicki
najgliwickim	gliwicki
najgliwickimi	gliwicki
gniew	gniew
gniewem	gniew
gniewie	gniew
gniewowi	gniew
gniewu	gniew
gniewscy	gniewski
gniewska	gniewski
gniewski	gniewski
gniewskich	gniewski
gniewskie	gniewski
gniewskiego	gniewski
gniewskiej	gniewski
gniewskiemu	gniewski
gniewskim	gniewski
gniewskimi	gniewski
gniezna	gniezno
gnieznem	gniezno
gniezno	gniezno
gnieznu	gniezno
goleniowa	goleniów
goleniowach	goleniów
goleniowami	goleniów
goleniowem	goleniów
goleniowie	goleniów
goleniowom	goleniów
goleniowowi	goleniów
goleniowy	goleniów
gorlic	gorlice
gorlicach	gorlice
gorlicami	gorlice
gorlice	gorlice
gorlicom	gorlice
gorliccy	gorlicki
gorlicka	gorlicki
gorlicki	gorlicki
gorlickich	gorlicki
gorlickie	gorlicki
gorlickiego	gorlicki
gorlickiej	gorlicki
gorlickiemu	gorlicki
gorlickim	gorlicki
gorlickimi	gorlicki
gorliccy	gorlicki
gorlicka	gorlicki
gorlicki	gorlicki
gorlickich	gorlicki
gorlickie	gorlicki
gorlickiego	gorlicki
gorlickiej	gorlicki
gorlickiemu	gorlicki
gorlickim	gorlicki
gorlickimi	gorlicki
najgorliccy	gorlicki
najgorlicka	gorlicki
najgorlicki	gorlicki
najgorlickich	gorlicki
najgorlickie	gorlicki
najgorlickiego	gorlicki
najgorlickiej	gorlicki
najgorlickiemu	gorlicki
najgorlickim	gorlicki
najgorlickimi	gorlicki
gorzowem wielkopolskim	gorzów wielkopolski
gorzowie wielkopolski	gorzów wielkopolski
gorzowie wielkopolskim	gorzów wielkopolski
gostyni	gostyń
gostynia	gostyń
gostyniach	gostyń
gostyniami	gostyń
gostynie	gostyń
gostyniem	gostyń
gostynio	gostyń
gostyniom	gostyń
gostyniowi	gostyń
gostyniu	gostyń
grodziscy	grodziski
grodziska	grodziski
grodziski	grodziski
grodziskich	grodziski
grodziskie	grodziski
grodziskiego	grodziski
grodziskiej	grodziski
grodziskiemu	grodziski
grodziskim	grodziski
grodziskimi	grodziski
grodziszczan	grodziszczanin
grodziszczanach	grodziszczanin
grodziszczanami	grodziszczanin
grodziszczanie	grodziszczanin
grodziszczanin	grodziszczanin
grodziszczanina	grodziszczanin
grodziszczaninem	grodziszczanin
grodziszczaninie	grodziszczanin
grodziszczaninowi	grodziszczanin
grodziszczanom	grodziszczanin
grodziszczance	grodziszczanka
grodziszczanek	grodziszczanka
grodziszczanka	grodziszczanka
grodziszczankach	grodziszczanka
grodziszczankami	grodziszczanka
grodziszczanki	grodziszczanka
grodziszczanko	grodziszczanka
grodziszczankom	grodziszczanka
gryfic	gryfice
gryficach	gryfice
gryficami	gryfice
gryfice	gryfice
gryficom	gryfice
hajnowscy	hajnowski
hajnowska	hajnowski
hajnowski	hajnowski
hajnowskich	hajnowski
hajnowskie	hajnowski
hajnowskiego	hajnowski
hajnowskiej	hajnowski
hajnowskiemu	hajnowski
hajnowskim	hajnowski
hajnowskimi	hajnowski
hel	hel
helem	hel
helowi	hel
helu	hel
helscy	helski
helska	helski
helski	helski
helskich	helski
helskie	helski
helskiego	helski
helskiej	helski
helskiemu	helski
helskim	helski
helskimi	helski
hrubieszowa	hrubieszów
hrubieszowem	hrubieszów
hrubieszowie	hrubieszów
hrubieszowowi	hrubieszów
imielin	imielin
imielina	imielin
imielinem	imielin
imielinie	imielin
imielinowi	imielin
jarek	jarek
jarka	jarek
jarkach	jarek
jarkami	jarek
jarkiem	jarek
jarkom	jarek
jarkowi	jarek
jarkowie	jarek
jarku	jarek
jasielscy	jasielski
jasielska	jasielski
jasielski	jasielski
jasielskich	jasielski
jasielskie	jasielski
jasielskiego	jasielski
jasielskiej	jasielski
jasielskiemu	jasielski
jasielskim	jasielski
jasielskimi	jasielski
jastrowia	jastrowie
jastrowie	jastrowie
jastrowiem	jastrowie
jastrowiu	jastrowie
jaworzniccy	jaworznicki
jaworznicka	jaworznicki
jaworznicki	jaworznicki
jaworznickich	jaworznicki
jaworznickie	jaworznicki
jaworznickiego	jaworznicki
jaworznickiej	jaworznicki
jaworznickiemu	jaworznicki
jaworznickim	jaworznicki
jaworznickimi	jaworznicki
jaworzniccy	jaworznicki
jaworznicka	jaworznicki
jaworznicki	jaworznicki
jaworznickich	jaworznicki
jaworznickie	jaworznicki
jaworznickiego	jaworznicki
jaworznickiej	jaworznicki
jaworznickiemu	jaworznicki
jaworznickim	jaworznicki
jaworznickimi	jaworznicki
najjaworzniccy	jaworznicki
najjaworznicka	jaworznicki
najjaworznicki	jaworznicki
najjaworznickich	jaworznicki
najjaworznickie	jaworznicki
najjaworznickiego	jaworznicki
najjaworznickiej	jaworznicki
najjaworznickiemu	jaworznicki
najjaworznickim	jaworznicki
najjaworznickimi	jaworznicki
jaworzn	jaworzno
jaworzna	jaworzno
jaworznach	jaworzno
jaworznami	jaworzno
jaworznem	jaworzno
jaworznie	jaworzno
jaworzno	jaworzno
jaworznom	jaworzno
jaworznu	jaworzno
jelcza-laskowic	jelcz-laskowice
jelczem-laskowicami	jelcz-laskowice
jelcz-laskowice	jelcz-laskowice
jelczowi-laskowicom	jelcz-laskowice
jelczu-laskowicach	jelcz-laskowice
jelczu-laskowice	jelcz-laskowice
kaletach	kalety
kaletami	kalety
kaletom	kalety
kalety	kalety
kaliscy	kaliski
kaliska	kaliski
kaliski	kaliski
kaliskich	kaliski
kaliskie	kaliski
kaliskiego	kaliski
kaliskiej	kaliski
kaliskiemu	kaliski
kaliskim	kaliski
kaliskimi	kaliski
kalisz	kalisz
kalisza	kalisz
kaliszach	kalisz
kaliszami	kalisz
kalisze	kalisz
kaliszem	kalisz
kaliszom	kalisz
kaliszowi	kalisz
kaliszowie	kalisz
kaliszu	kalisz
kaliszan	kaliszanin
kaliszanach	kaliszanin
kaliszanami	kaliszanin
kaliszanie	kaliszanin
kaliszanin	kaliszanin
kaliszanina	kaliszanin
kaliszaninem	kaliszanin
kaliszaninie	kaliszanin
kaliszaninowi	kaliszanin
kaliszanom	kaliszanin
kaliszance	kaliszanka
kaliszanek	kaliszanka
kaliszanka	kaliszanka
kaliszankach	kaliszanka
kaliszankami	kaliszanka
kaliszanki	kaliszanka
kaliszanko	kaliszanka
kaliszankom	kaliszanka
kartuz	kartuzy
kartuzach	kartuzy
kartuzami	kartuzy
kartuzom	kartuzy
kartuzy	kartuzy
katowic	katowice
katowicach	katowice
katowicami	katowice
katowice	katowice
katowicom	katowice
katowiccy	katowicki
katowicka	katowicki
katowicki	katowicki
katowickich	katowicki
katowickie	katowicki
katowickiego	katowicki
katowickiej	katowicki
katowickiemu	katowicki
katowickim	katowicki
katowickimi	katowicki
katowiczan	katowiczanin
katowiczanach	katowiczanin
katowiczanami	katowiczanin
katowiczanie	katowiczanin
katowiczanin	katowiczanin
katowiczanina	katowiczanin
katowiczaninem	katowiczanin
katowiczaninie	katowiczanin
katowiczaninowi	katowiczanin
katowiczanom	katowiczanin
katowiczance	katowiczanka
katowiczanek	katowiczanka
katowiczanka	katowiczanka
katowiczankach	katowiczanka
katowiczankami	katowiczanka
katowiczanki	katowiczanka
katowiczanko	katowiczanka
katowiczankom	katowiczanka
kazimierz dolny	kazimierz dolny
kazimierza dolnego	kazimierz dolny
kazimierzem dolnym	kazimierz dolny
kazimierzowi dolnemu	kazimierz dolny
kazimierzu dolny	kazimierz dolny
kazimierzu dolnym	kazimierz dolny
kielc	kielce
kielcach	kielce
kielcami	kielce
kielce	kielce
kielcom	kielce
kielczan	kielczanin
kielczanach	kielczanin
kielczanami	kielczanin
kielczanie	kielczanin
kielczanin	kielczanin
kielczanina	kielczanin
kielczaninem	kielczanin
kielczaninie	kielczanin
kielczaninowi	kielczanin
kielczanom	kielczanin
kielczance	kielczanka
kielczanek	kielczanka
kielczanka	kielczanka
kielczankach	kielczanka
kielczankami	kielczanka
kielczanki	kielczanka
kielczanko	kielczanka
kielczankom	kielczanka
kieleccy	kielecki
kielecka	kielecki
kielecki	kielecki
kieleckich	kielecki
kieleckie	kielecki
kieleckiego	kielecki
kieleckiej	kielecki
kieleckiemu	kielecki
kieleckim	kielecki
kieleckimi	kielecki
kieleckie	kieleckie
kieleckiego	kieleckie
kieleckiem	kieleckie
kieleckiemu	kieleckie
kole	koło
kolbuszowa	kolbuszowa
kolbuszowej	kolbuszowa
kolbuszowian	kolbuszowianin
kolbuszowianach	kolbuszowianin
kolbuszowianami	kolbuszowianin
kolbuszowianie	kolbuszowianin
kolbuszowianin	kolbuszowianin
kolbuszowianina	kolbuszowianin
kolbuszowianinem	kolbuszowianin
kolbuszowianinie	kolbuszowianin
kolbuszowianinowi	kolbuszowianin
kolbuszowianom	kolbuszowianin
kolbuszowscy	kolbuszowski
kolbuszowska	kolbuszowski
kolbuszowski	kolbuszowski
kolbuszowskich	kolbuszowski
kolbuszowskie	kolbuszowski
kolbuszowskiego	kolbuszowski
kolbuszowskiej	kolbuszowski
kolbuszowskiemu	kolbuszowski
kolbuszowskim	kolbuszowski
kolbuszowskimi	kolbuszowski
koluszek	koluszki
koluszkach	koluszki
koluszkami	koluszki
koluszki	koluszki
koluszkom	koluszki
konecczan	konecczanin
konecczanach	konecczanin
konecczanami	konecczanin
konecczanie	konecczanin
konecczanin	konecczanin
konecczanina	konecczanin
konecczaninem	konecczanin
konecczaninie	konecczanin
konecczaninowi	konecczanin
konecczanom	konecczanin
konecczance	konecczanka
konecczanek	konecczanka
konecczanka	konecczanka
konecczankach	konecczanka
konecczankami	konecczanka
konecczanki	konecczanka
konecczanko	konecczanka
konecczankom	konecczanka
koneccy	konecki
konecka	konecki
konecki	konecki
koneckich	konecki
koneckie	konecki
koneckiego	konecki
koneckiej	konecki
koneckiemu	konecki
koneckim	konecki
koneckimi	konecki
konin	konin
konina	konin
koninem	konin
koninie	konin
koninowi	konin
koninian	koninianin
koninianach	koninianin
koninianami	koninianin
koninianie	koninianin
koninianin	koninianin
koninianina	koninianin
koninianinem	koninianin
koninianinie	koninianin
koninianinowi	koninianin
koninianom	koninianin
koniniance	koninianka
koninianek	koninianka
koninianka	koninianka
koniniankach	koninianka
koniniankami	koninianka
koninianki	koninianka
koninianko	koninianka
koniniankom	koninianka
kopacz	kopacz
kopacza	kopacz
kopaczach	kopacz
kopaczami	kopacz
kopacze	kopacz
kopaczem	kopacz
kopaczom	kopacz
kopaczowi	kopacz
kopaczu	kopacz
kopaczy	kopacz
kostrzyn	kostrzyn
kostrzyna	kostrzyn
kostrzynem	kostrzyn
kostrzynie	kostrzyn
kostrzynowi	kostrzyn
koszalin	koszalin
koszalina	koszalin
koszalinem	koszalin
koszalinie	koszalin
koszalinowi	koszalin
koszalinian	koszalinianin
koszalinianach	koszalinianin
koszalinianami	koszalinianin
koszalinianie	koszalinianin
koszalinianin	koszalinianin
koszalinianina	koszalinianin
koszalinianinem	koszalinianin
koszalinianinie	koszalinianin
koszalinianinowi	koszalinianin
koszalinianom	koszalinianin
kowarscy	kowarski
kowarska	kowarski
kowarski	kowarski
kowarskich	kowarski
kowarskie	kowarski
kowarskiego	kowarski
kowarskiej	kowarski
kowarskiemu	kowarski
kowarskim	kowarski
kowarskimi	kowarski
kowar	kowary
kowarach	kowary
kowarami	kowary
kowarom	kowary
kowary	kowary
kozienic	kozienice
kozienicach	kozienice
kozienicami	kozienice
kozienice	kozienice
kozienicom	kozienice
krak	krak
kraka	krak
krakiem	krak
krakowi	krak
kraku	krak
krakowa	kraków
krakowach	kraków
krakowami	kraków
krakowem	kraków
krakowie	kraków
krakowom	kraków
krakowowi	kraków
krakowy	kraków
krakowiak	krakowiak
krakowiaka	krakowiak
krakowiakach	krakowiak
krakowiakami	krakowiak
krakowiakiem	krakowiak
krakowiakom	krakowiak
krakowiakowi	krakowiak
krakowiakowie	krakowiak
krakowiaku	krakowiak
krakowscy	krakowski
krakowska	krakowski
krakowski	krakowski
krakowskich	krakowski
krakowskie	krakowski
krakowskiego	krakowski
krakowskiej	krakowski
krakowskiemu	krakowski
krakowskim	krakowski
krakowskimi	krakowski
krakowscy	krakowski
krakowska	krakowski
krakowski	krakowski
krakowskich	krakowski
krakowskie	krakowski
krakowskiego	krakowski
krakowskiej	krakowski
krakowskiemu	krakowski
krakowskim	krakowski
krakowskimi	krakowski
najkrakowscy	krakowski
najkrakowska	krakowski
najkrakowski	krakowski
najkrakowskich	krakowski
najkrakowskie	krakowski
najkrakowskiego	krakowski
najkrakowskiej	krakowski
najkrakowskiemu	krakowski
najkrakowskim	krakowski
najkrakowskimi	krakowski
krakus	krakus
krakusa	krakus
krakusach	krakus
krakusami	krakus
krakusem	krakus
krakusie	krakus
krakusom	krakus
krakusowi	krakus
krakusy	krakus
krakusce	krakuska
krakusek	krakuska
krakuska	krakuska
krakuskach	krakuska
krakuskami	krakuska
krakuski	krakuska
krakusko	krakuska
krakuskom	krakuska
krapkowic	krapkowice
krapkowicach	krapkowice
krapkowicami	krapkowice
krapkowice	krapkowice
krapkowicom	krapkowice
krasnegostawu	krasnystaw
krasnemustawowi	krasnystaw
krasnymstawem	krasnystaw
krasnymstawie	krasnystaw
krasnystaw	krasnystaw
krasnystawie	krasnystaw
krynica morska	krynica morska
krynico morska	krynica morska
krynicy morskiej	krynica morska
kryniczna	kryniczny
kryniczne	kryniczny
krynicznego	kryniczny
krynicznej	kryniczny
krynicznemu	kryniczny
kryniczni	kryniczny
kryniczny	kryniczny
krynicznych	kryniczny
krynicznym	kryniczny
krynicznymi	kryniczny
krzepic	krzepice
krzepicach	krzepice
krzepicami	krzepice
krzepice	krzepice
krzepicom	krzepice
krzeszowic	krzeszowice
krzeszowicach	krzeszowice
krzeszowicami	krzeszowice
krzeszowice	krzeszowice
krzeszowicom	krzeszowice
kutna	kutno
kutnem	kutno
kutnie	kutno
kutno	kutno
kutnu	kutno
legnica	legnica
legnico	legnica
legnicy	legnica
legniccy	legnicki
legnicka	legnicki
legnicki	legnicki
legnickich	legnicki
legnickie	legnicki
legnickiego	legnicki
legnickiej	legnicki
legnickiemu	legnicki
legnickim	legnicki
legnickimi	legnicki
legniccy	legnicki
legnicka	legnicki
legnicki	legnicki
legnickich	legnicki
legnickie	legnicki
legnickiego	legnicki
legnickiej	legnicki
legnickiemu	legnicki
legnickim	legnicki
legnickimi	legnicki
najlegniccy	legnicki
najlegnicka	legnicki
najlegnicki	legnicki
najlegnickich	legnicki
najlegnickie	legnicki
najlegnickiego	legnicki
najlegnickiej	legnicki
najlegnickiemu	legnicki
najlegnickim	legnicki
najlegnickimi	legnicki
legniczan	legniczanin
legniczanach	legniczanin
legniczanami	legniczanin
legniczanie	legniczanin
legniczanin	legniczanin
legniczanina	legniczanin
legniczaninem	legniczanin
legniczaninie	legniczanin
legniczaninowi	legniczanin
legniczanom	legniczanin
legniczance	legniczanka
legniczanek	legniczanka
legniczanka	legniczanka
legniczankach	legniczanka
legniczankami	legniczanka
legniczanki	legniczanka
legniczanko	legniczanka
legniczankom	legniczanka
lesznian	lesznianin
lesznianach	lesznianin
lesznianami	lesznianin
lesznianie	lesznianin
lesznianin	lesznianin
lesznianina	lesznianin
lesznianinem	lesznianin
lesznianinie	lesznianin
lesznianinowi	lesznianin
lesznianom	lesznianin
leszniance	lesznianka
lesznianek	lesznianka
lesznianka	lesznianka
leszniankach	lesznianka
leszniankami	lesznianka
lesznianki	lesznianka
lesznianko	lesznianka
leszniankom	lesznianka
leszna	leszno
lesznem	leszno
lesznie	leszno
leszno	leszno
lesznu	leszno
limanowa	limanowa
limanowej	limanowa
lubartowscy	lubartowski
lubartowska	lubartowski
lubartowski	lubartowski
lubartowskich	lubartowski
lubartowskie	lubartowski
lubartowskiego	lubartowski
lubartowskiej	lubartowski
lubartowskiemu	lubartowski
lubartowskim	lubartowski
lubartowskimi	lubartowski
lubawce	lubawka
lubawka	lubawka
lubawki	lubawka
lubawko	lubawka
lubelscy	lubelski
lubelska	lubelski
lubelski	lubelski
lubelskich	lubelski
lubelskie	lubelski
lubelskiego	lubelski
lubelskiej	lubelski
lubelskiemu	lubelski
lubelskim	lubelski
lubelskimi	lubelski
lubelszczyzna	lubelszczyzna
lubelszczyzno	lubelszczyzna
lubelszczyzny	lubelszczyzna
lubin	lubin
lubina	lubin
lubinem	lubin
lubinie	lubin
lubinowi	lubin
lubinian	lubinianin
lubinianach	lubinianin
lubinianami	lubinianin
lubinianie	lubinianin
lubinianin	lubinianin
lubinianina	lubinianin
lubinianinem	lubinianin
lubinianinie	lubinianin
lubinianinowi	lubinianin
lubinianom	lubinianin
lubiniance	lubinianka
lubinianka	lubinianka
lubinianki	lubinianka
lubinianko	lubinianka
lublin	lublin
lublina	lublin
lublinach	lublin
lublinami	lublin
lubline	lublin
lublinem	lublin
lublinie	lublin
lublinom	lublin
lublinowi	lublin
"lublins"""	lublin
lublinu	lublin
lubliny	lublin
lublinian	lublinianin
lublinianach	lublinianin
lublinianami	lublinianin
lublinianie	lublinianin
lublinianin	lublinianin
lublinianina	lublinianin
lublinianinem	lublinianin
lublinianinie	lublinianin
lublinianinowi	lublinianin
lublinianom	lublinianin
lubliniance	lublinianka
lublinianek	lublinianka
lublinianka	lublinianka
lubliniankach	lublinianka
lubliniankami	lublinianka
lublinianki	lublinianka
lublinianko	lublinianka
lubliniankom	lublinianka
lubliniec	lubliniec
lubonia	luboń
luboniem	luboń
luboniowi	luboń
luboniu	luboń
lubonian	lubonianin
lubonianach	lubonianin
lubonianami	lubonianin
lubonianie	lubonianin
lubonianin	lubonianin
lubonianina	lubonianin
lubonianinem	lubonianin
lubonianinie	lubonianin
lubonianinowi	lubonianin
lubonianom	lubonianin
luboniance	lubonianka
lubonianek	lubonianka
lubonianka	lubonianka
luboniankach	lubonianka
luboniankami	lubonianka
lubonianki	lubonianka
lubonianko	lubonianka
luboniankom	lubonianka
malborczan	malborczanin
malborczanach	malborczanin
malborczanami	malborczanin
malborczanie	malborczanin
malborczanin	malborczanin
malborczanina	malborczanin
malborczaninem	malborczanin
malborczaninie	malborczanin
malborczaninowi	malborczanin
malborczanom	malborczanin
malborczance	malborczanka
malborczanek	malborczanka
malborczanka	malborczanka
malborczankach	malborczanka
malborczankami	malborczanka
malborczanki	malborczanka
malborczanko	malborczanka
malborczankom	malborczanka
malbork	malbork
malborka	malbork
malborkach	malbork
malborkami	malbork
malborki	malbork
malborkiem	malbork
malborkom	malbork
malborkowi	malbork
malborku	malbork
malborscy	malborski
malborska	malborski
malborski	malborski
malborskich	malborski
malborskie	malborski
malborskiego	malborski
malborskiej	malborski
malborskiemu	malborski
malborskim	malborski
malborskimi	malborski
miech	miech
miecha	miech
miechach	miech
miechami	miech
miechem	miech
miechom	miech
miechowi	miech
miechu	miech
miechy	miech
mielca	mielec
mielcem	mielec
mielcowi	mielec
mielcu	mielec
mielec	mielec
mieleccy	mielecki
mielecka	mielecki
mielecki	mielecki
mieleckich	mielecki
mieleckie	mielecki
mieleckiego	mielecki
mieleckiej	mielecki
mieleckiemu	mielecki
mieleckim	mielecki
mieleckimi	mielecki
mieleccy	mielecki
mielecka	mielecki
mielecki	mielecki
mieleckich	mielecki
mieleckie	mielecki
mieleckiego	mielecki
mieleckiej	mielecki
mieleckiemu	mielecki
mieleckim	mielecki
mieleckimi	mielecki
najmieleccy	mielecki
najmielecka	mielecki
najmielecki	mielecki
najmieleckich	mielecki
najmieleckie	mielecki
najmieleckiego	mielecki
najmieleckiej	mielecki
najmieleckiemu	mielecki
najmieleckim	mielecki
najmieleckimi	mielecki
more	mos
morem	mos
moribus	mos
moris	mos
morum	mos
mos	mos
mosina	mosina
mosinie	mosina
mosino	mosina
mosiny	mosina
mosinian	mosinianin
mosinianach	mosinianin
mosinianami	mosinianin
mosinianie	mosinianin
mosinianin	mosinianin
mosinianina	mosinianin
mosinianinem	mosinianin
mosinianinie	mosinianin
mosinianinowi	mosinianin
mosinianom	mosinianin
mosiniance	mosinianka
mosinianek	mosinianka
mosinianka	mosinianka
mosiniankach	mosinianka
mosiniankami	mosinianka
mosinianki	mosinianka
mosinianko	mosinianka
mosiniankom	mosinianka
mszan dolnych	mszana dolna
mszana dolna	mszana dolna
mszanach dolnych	mszana dolna
mszanami dolnymi	mszana dolna
mszanie dolnej	mszana dolna
mszano dolna	mszana dolna
mszanom dolnym	mszana dolna
mszany dolne	mszana dolna
mszany dolnej	mszana dolna
nowa ruda	nowa ruda
nowa rudo	nowa ruda
nowej rudy	nowa ruda
nowej rudzie	nowa ruda
nowogard	nowogard
nowogardem	nowogard
nowogardowi	nowogard
nowogardzie	nowogard
noworudzian	noworudzianin
noworudzianach	noworudzianin
noworudzianami	noworudzianin
noworudzianie	noworudzianin
noworudzianin	noworudzianin
noworudzianina	noworudzianin
noworudzianinem	noworudzianin
noworudzianinie	noworudzianin
noworudzianinowi	noworudzianin
noworudzianom	noworudzianin
noworudziance	noworudzianka
noworudzianek	noworudzianka
noworudzianka	noworudzianka
noworudziankach	noworudzianka
noworudziankami	noworudzianka
noworudzianki	noworudzianka
noworudzianko	noworudzianka
noworudziankom	noworudzianka
noworudzcy	noworudzki
noworudzka	noworudzki
noworudzki	noworudzki
noworudzkich	noworudzki
noworudzkie	noworudzki
noworudzkiego	noworudzki
noworudzkiej	noworudzki
noworudzkiemu	noworudzki
noworudzkim	noworudzki
noworudzkimi	noworudzki
najnoworudzcy	noworudzki
najnoworudzka	noworudzki
najnoworudzki	noworudzki
najnoworudzkich	noworudzki
najnoworudzkie	noworudzki
najnoworudzkiego	noworudzki
najnoworudzkiej	noworudzki
najnoworudzkiemu	noworudzki
najnoworudzkim	noworudzki
najnoworudzkimi	noworudzki
noworudzcy	noworudzki
noworudzka	noworudzki
noworudzki	noworudzki
noworudzkich	noworudzki
noworudzkie	noworudzki
noworudzkiego	noworudzki
noworudzkiej	noworudzki
noworudzkiemu	noworudzki
noworudzkim	noworudzki
noworudzkimi	noworudzki
nowotomyscy	nowotomyski
nowotomyska	nowotomyski
nowotomyski	nowotomyski
nowotomyskich	nowotomyski
nowotomyskie	nowotomyski
nowotomyskiego	nowotomyski
nowotomyskiej	nowotomyski
nowotomyskiemu	nowotomyski
nowotomyskim	nowotomyski
nowotomyskimi	nowotomyski
nys	nysa
nys	nysa
nysa	nysa
nysa	nysa
nysach	nysa
nysach	nysa
nysami	nysa
nysami	nysa
nysie	nysa
nysie	nysa
nyso	nysa
nyso	nysa
nysom	nysa
nysom	nysa
nysy	nysa
nysy	nysa
nysce	nyska
nysek	nyska
nyskach	nyska
nyskami	nyska
nysko	nyska
nyskom	nyska
nyscy	nyski
nyska	nyski
nyski	nyski
nyskich	nyski
nyskie	nyski
nyskiego	nyski
nyskiej	nyski
nyskiemu	nyski
nyskim	nyski
nyskimi	nyski
oborniccy	obornicki
obornicka	obornicki
obornicki	obornicki
obornickich	obornicki
obornickie	obornicki
obornickiego	obornicki
obornickiej	obornicki
obornickiemu	obornicki
obornickim	obornicki
obornickimi	obornicki
najoborniccy	obornicki
najobornicka	obornicki
najobornicki	obornicki
najobornickich	obornicki
najobornickie	obornicki
najobornickiego	obornicki
najobornickiej	obornicki
najobornickiemu	obornicki
najobornickim	obornicki
najobornickimi	obornicki
oborniccy	obornicki
obornicka	obornicki
obornicki	obornicki
obornickich	obornicki
obornickie	obornicki
obornickiego	obornicki
obornickiej	obornicki
obornickiemu	obornicki
obornickim	obornicki
obornickimi	obornicki
oborniczan	oborniczanin
oborniczanach	oborniczanin
oborniczanami	oborniczanin
oborniczanie	oborniczanin
oborniczanin	oborniczanin
oborniczanina	oborniczanin
oborniczaninem	oborniczanin
oborniczaninie	oborniczanin
oborniczaninowi	oborniczanin
oborniczanom	oborniczanin
obornik	obornik
obornika	obornik
obornikiem	obornik
obornikowi	obornik
oborniku	obornik
obornik	oborniki
obornikach	oborniki
obornikami	oborniki
oborniki	oborniki
obornikom	oborniki
oleccy	olecki
olecka	olecki
olecki	olecki
oleckich	olecki
oleckie	olecki
oleckiego	olecki
oleckiej	olecki
oleckiemu	olecki
oleckim	olecki
oleckimi	olecki
najoleccy	olecki
najolecka	olecki
najolecki	olecki
najoleckich	olecki
najoleckie	olecki
najoleckiego	olecki
najoleckiej	olecki
najoleckiemu	olecki
najoleckim	olecki
najoleckimi	olecki
oleccy	olecki
olecka	olecki
olecki	olecki
oleckich	olecki
oleckie	olecki
oleckiego	olecki
oleckiej	olecki
oleckiemu	olecki
oleckim	olecki
oleckimi	olecki
olkuscy	olkuski
olkuska	olkuski
olkuski	olkuski
olkuskich	olkuski
olkuskie	olkuski
olkuskiego	olkuski
olkuskiej	olkuski
olkuskiemu	olkuski
olkuskim	olkuski
olkuskimi	olkuski
olsztyn	olsztyn
olsztyna	olsztyn
olsztynem	olsztyn
olsztynie	olsztyn
olsztynowi	olsztyn
olsztyniacy	olsztyniak
olsztyniak	olsztyniak
olsztyniaka	olsztyniak
olsztyniakach	olsztyniak
olsztyniakami	olsztyniak
olsztyniakiem	olsztyniak
olsztyniakom	olsztyniak
olsztyniakowi	olsztyniak
olsztyniaku	olsztyniak
olsztynian	olsztynianin
olsztynianach	olsztynianin
olsztynianami	olsztynianin
olsztynianie	olsztynianin
olsztynianin	olsztynianin
olsztynianina	olsztynianin
olsztynianinem	olsztynianin
olsztynianinie	olsztynianin
olsztynianinowi	olsztynianin
olsztynianom	olsztynianin
olsztyniance	olsztynianka
olsztynianek	olsztynianka
olsztynianka	olsztynianka
olsztyniankach	olsztynianka
olsztyniankami	olsztynianka
olsztynianki	olsztynianka
olsztynianko	olsztynianka
olsztyniankom	olsztynianka
opolan	opolanin
opolan	opolanin
opolanach	opolanin
opolanach	opolanin
opolanami	opolanin
opolanami	opolanin
opolanie	opolanin
opolanie	opolanin
opolanin	opolanin
opolanin	opolanin
opolanina	opolanin
opolanina	opolanin
opolaninem	opolanin
opolaninem	opolanin
opolaninie	opolanin
opolaninie	opolanin
opolaninowi	opolanin
opolaninowi	opolanin
opolanom	opolanin
opolanom	opolanin
opolance	opolanka
opolance	opolanka
opolanek	opolanka
opolanek	opolanka
opolanka	opolanka
opolanka	opolanka
opolankach	opolanka
opolankach	opolanka
opolankami	opolanka
opolankami	opolanka
opolanki	opolanka
opolanki	opolanka
opolanko	opolanka
opolanko	opolanka
opolankom	opolanka
opolankom	opolanka
opola	opole
opolach	opole
opolami	opole
opole	opole
opolem	opole
opoli	opole
opolom	opole
opolu	opole
opolscy	opolski
opolska	opolski
opolski	opolski
opolskich	opolski
opolskie	opolski
opolskiego	opolski
opolskiej	opolski
opolskiemu	opolski
opolskim	opolski
opolskimi	opolski
opolszczyzna	opolszczyzna
opolszczyzno	opolszczyzna
opolszczyzny	opolszczyzna
pabianic	pabianice
pabianicach	pabianice
pabianicami	pabianice
pabianice	pabianice
pabianicom	pabianice
pabianiccy	pabianicki
pabianicka	pabianicki
pabianicki	pabianicki
pabianickich	pabianicki
pabianickie	pabianicki
pabianickiego	pabianicki
pabianickiej	pabianicki
pabianickiemu	pabianicki
pabianickim	pabianicki
pabianickimi	pabianicki
najpabianiccy	pabianicki
najpabianicka	pabianicki
najpabianicki	pabianicki
najpabianickich	pabianicki
najpabianickie	pabianicki
najpabianickiego	pabianicki
najpabianickiej	pabianicki
najpabianickiemu	pabianicki
najpabianickim	pabianicki
najpabianickimi	pabianicki
pabianiccy	pabianicki
pabianicka	pabianicki
pabianicki	pabianicki
pabianickich	pabianicki
pabianickie	pabianicki
pabianickiego	pabianicki
pabianickiej	pabianicki
pabianickiemu	pabianicki
pabianickim	pabianicki
pabianickimi	pabianicki
pelplin	pelplin
pelplina	pelplin
pelplinem	pelplin
pelplinie	pelplin
pelplinowi	pelplin
pelplinian	pelplinianin
pelplinianach	pelplinianin
pelplinianami	pelplinianin
pelplinianie	pelplinianin
pelplinianin	pelplinianin
pelplinianina	pelplinianin
pelplinianinem	pelplinianin
pelplinianinie	pelplinianin
pelplinianinowi	pelplinianin
pelplinianom	pelplinianin
pelpliniance	pelplinianka
pelplinianek	pelplinianka
pelplinianka	pelplinianka
pelpliniankach	pelplinianka
pelpliniankami	pelplinianka
pelplinianki	pelplinianka
pelplinianko	pelplinianka
pelpliniankom	pelplinianka
piekarscy	piekarski
piekarska	piekarski
piekarski	piekarski
piekarskich	piekarski
piekarskie	piekarski
piekarskiego	piekarski
piekarskiej	piekarski
piekarskiemu	piekarski
piekarskim	piekarski
piekarskimi	piekarski
piekarzan	piekarzanin
piekarzanach	piekarzanin
piekarzanami	piekarzanin
piekarzanie	piekarzanin
piekarzanin	piekarzanin
piekarzanina	piekarzanin
piekarzaninem	piekarzanin
piekarzaninie	piekarzanin
piekarzaninowi	piekarzanin
piekarzanom	piekarzanin
piekarzance	piekarzanka
piekarzanek	piekarzanka
piekarzanka	piekarzanka
piekarzankach	piekarzanka
piekarzankami	piekarzanka
piekarzanki	piekarzanka
piekarzanko	piekarzanka
piekarzankom	piekarzanka
pieszyc	pieszyce
pieszycach	pieszyce
pieszycami	pieszyce
pieszyce	pieszyce
pieszycom	pieszyce
pieszyccy	pieszycki
pieszycka	pieszycki
pieszycki	pieszycki
pieszyckich	pieszycki
pieszyckie	pieszycki
pieszyckiego	pieszycki
pieszyckiej	pieszycki
pieszyckiemu	pieszycki
pieszyckim	pieszycki
pieszyckimi	pieszycki
pieszyczan	pieszyczanin
pieszyczanach	pieszyczanin
pieszyczanami	pieszyczanin
pieszyczanie	pieszyczanin
pieszyczanin	pieszyczanin
pieszyczanina	pieszyczanin
pieszyczaninem	pieszyczanin
pieszyczaninie	pieszyczanin
pieszyczaninowi	pieszyczanin
pieszyczanom	pieszyczanin
pieszyczance	pieszyczanka
pieszyczanek	pieszyczanka
pieszyczanka	pieszyczanka
pieszyczankach	pieszyczanka
pieszyczankami	pieszyczanka
pieszyczanki	pieszyczanka
pieszyczanko	pieszyczanka
pieszyczankom	pieszyczanka
pile	piła
pileccy	pilecki
pilecki	pilecki
pileckich	pilecki
pileckiego	pilecki
pileckiemu	pilecki
pileckim	pilecki
pileckimi	pilecki
pilscy	pilski
pilska	pilski
pilski	pilski
pilskich	pilski
pilskie	pilski
pilskiego	pilski
pilskiej	pilski
pilskiemu	pilski
pilskim	pilski
pilskimi	pilski
piotrkowa trybunalskiego	piotrków trybunalski
piotrkowem trybunalskim	piotrków trybunalski
piotrkowie trybunalski	piotrków trybunalski
piotrkowie trybunalskim	piotrków trybunalski
piotrkowowi trybunalskiemu	piotrków trybunalski
piotrkowscy	piotrkowski
piotrkowska	piotrkowski
piotrkowski	piotrkowski
piotrkowskich	piotrkowski
piotrkowskie	piotrkowski
piotrkowskiego	piotrkowski
piotrkowskiej	piotrkowski
piotrkowskiemu	piotrkowski
piotrkowskim	piotrkowski
piotrkowskimi	piotrkowski
piscy	piski
piska	piski
piski	piski
piskich	piski
piskie	piski
piskiego	piski
piskiej	piski
piskiemu	piski
piskim	piski
piskimi	piski
pisz	pisz
piszem	pisz
piszowi	pisz
piszu	pisz
piszan	piszanin
piszanach	piszanin
piszanami	piszanin
piszanie	piszanin
piszanin	piszanin
piszanina	piszanin
piszaninem	piszanin
piszaninie	piszanin
piszaninowi	piszanin
piszanom	piszanin
piszance	piszanka
piszanek	piszanka
piszanka	piszanka
piszankach	piszanka
piszankami	piszanka
piszanki	piszanka
piszanko	piszanka
piszankom	piszanka
podbrodniccy	podbrodnicki
podbrodnicka	podbrodnicki
podbrodnicki	podbrodnicki
podbrodnickich	podbrodnicki
podbrodnickie	podbrodnicki
podbrodnickiego	podbrodnicki
podbrodnickiej	podbrodnicki
podbrodnickiemu	podbrodnicki
podbrodnickim	podbrodnicki
podbrodnickimi	podbrodnicki
podbydgoscy	podbydgoski
podbydgoska	podbydgoski
podbydgoski	podbydgoski
podbydgoskich	podbydgoski
podbydgoskie	podbydgoski
podbydgoskiego	podbydgoski
podbydgoskiej	podbydgoski
podbydgoskiemu	podbydgoski
podbydgoskim	podbydgoski
podbydgoskimi	podbydgoski
podbytomscy	podbytomski
podbytomska	podbytomski
podbytomski	podbytomski
podbytomskich	podbytomski
podbytomskie	podbytomski
podbytomskiego	podbytomski
podbytomskiej	podbytomski
podbytomskiemu	podbytomski
podbytomskim	podbytomski
podbytomskimi	podbytomski
podchorzowscy	podchorzowski
podchorzowska	podchorzowski
podchorzowski	podchorzowski
podchorzowskich	podchorzowski
podchorzowskie	podchorzowski
podchorzowskiego	podchorzowski
podchorzowskiej	podchorzowski
podchorzowskiemu	podchorzowski
podchorzowskim	podchorzowski
podchorzowskimi	podchorzowski
podgliwiccy	podgliwicki
podgliwicka	podgliwicki
podgliwicki	podgliwicki
podgliwickich	podgliwicki
podgliwickie	podgliwicki
podgliwickiego	podgliwicki
podgliwickiej	podgliwicki
podgliwickiemu	podgliwicki
podgliwickim	podgliwicki
podgliwickimi	podgliwicki
podkatowiccy	podkatowicki
podkatowicka	podkatowicki
podkatowicki	podkatowicki
podkatowickich	podkatowicki
podkatowickie	podkatowicki
podkatowickiego	podkatowicki
podkatowickiej	podkatowicki
podkatowickiemu	podkatowicki
podkatowickim	podkatowicki
podkatowickimi	podkatowicki
podkieleccy	podkielecki
podkielecka	podkielecki
podkielecki	podkielecki
podkieleckich	podkielecki
podkieleckie	podkielecki
podkieleckiego	podkielecki
podkieleckiej	podkielecki
podkieleckiemu	podkielecki
podkieleckim	podkielecki
podkieleckimi	podkielecki
podlegniccy	podlegnicki
podlegnicka	podlegnicki
podlegnicki	podlegnicki
podlegnickich	podlegnicki
podlegnickie	podlegnicki
podlegnickiego	podlegnicki
podlegnickiej	podlegnicki
podlegnickiemu	podlegnicki
podlegnickim	podlegnicki
podlegnickimi	podlegnicki
podopolscy	podopolski
podopolska	podopolski
podopolski	podopolski
podopolskich	podopolski
podopolskie	podopolski
podopolskiego	podopolski
podopolskiej	podopolski
podopolskiemu	podopolski
podopolskim	podopolski
podopolskimi	podopolski
podpabianiccy	podpabianicki
podpabianicka	podpabianicki
podpabianicki	podpabianicki
podpabianickich	podpabianicki
podpabianickie	podpabianicki
podpabianickiego	podpabianicki
podpabianickiej	podpabianicki
podpabianickiemu	podpabianicki
podpabianickim	podpabianicki
podpabianickimi	podpabianicki
podpilscy	podpilski
podpilska	podpilski
podpilski	podpilski
podpilskich	podpilski
podpilskie	podpilski
podpilskiego	podpilski
podpilskiej	podpilski
podpilskiemu	podpilski
podpilskim	podpilski
podpilskimi	podpilski
podprzemyscy	podprzemyski
podprzemyska	podprzemyski
podprzemyski	podprzemyski
podprzemyskich	podprzemyski
podprzemyskie	podprzemyski
podprzemyskiego	podprzemyski
podprzemyskiej	podprzemyski
podprzemyskiemu	podprzemyski
podprzemyskim	podprzemyski
podprzemyskimi	podprzemyski
podradomscy	podradomski
podradomska	podradomski
podradomski	podradomski
podradomskich	podradomski
podradomskie	podradomski
podradomskiego	podradomski
podradomskiej	podradomski
podradomskiemu	podradomski
podradomskim	podradomski
podradomskimi	podradomski
podrybniccy	podrybnicki
podrybnicka	podrybnicki
podrybnicki	podrybnicki
podrybnickich	podrybnicki
podrybnickie	podrybnicki
podrybnickiego	podrybnicki
podrybnickiej	podrybnicki
podrybnickiemu	podrybnicki
podrybnickim	podrybnicki
podrybnickimi	podrybnicki
podrzeszowscy	podrzeszowski
podrzeszowska	podrzeszowski
podrzeszowski	podrzeszowski
podrzeszowskich	podrzeszowski
podrzeszowskie	podrzeszowski
podrzeszowskiego	podrzeszowski
podrzeszowskiej	podrzeszowski
podrzeszowskiemu	podrzeszowski
podrzeszowskim	podrzeszowski
podrzeszowskimi	podrzeszowski
podsiedleccy	podsiedlecki
podsiedlecka	podsiedlecki
podsiedlecki	podsiedlecki
podsiedleckich	podsiedlecki
podsiedleckie	podsiedlecki
podsiedleckiego	podsiedlecki
podsiedleckiej	podsiedlecki
podsiedleckiemu	podsiedlecki
podsiedleckim	podsiedlecki
podsiedleckimi	podsiedlecki
podsosnowieccy	podsosnowiecki
podsosnowiecka	podsosnowiecki
podsosnowiecki	podsosnowiecki
podsosnowieckich	podsosnowiecki
podsosnowieckie	podsosnowiecki
podsosnowieckiego	podsosnowiecki
podsosnowieckiej	podsosnowiecki
podsosnowieckiemu	podsosnowiecki
podsosnowieckim	podsosnowiecki
podsosnowieckimi	podsosnowiecki
podtarnowscy	podtarnowski
podtarnowska	podtarnowski
podtarnowski	podtarnowski
podtarnowskich	podtarnowski
podtarnowskie	podtarnowski
podtarnowskiego	podtarnowski
podtarnowskiej	podtarnowski
podtarnowskiemu	podtarnowski
podtarnowskim	podtarnowski
podtarnowskimi	podtarnowski
podwadowiccy	podwadowicki
podwadowicka	podwadowicki
podwadowicki	podwadowicki
podwadowickich	podwadowicki
podwadowickie	podwadowicki
podwadowickiego	podwadowicki
podwadowickiej	podwadowicki
podwadowickiemu	podwadowicki
podwadowickim	podwadowicki
podwadowickimi	podwadowicki
podwarszawscy	podwarszawski
podwarszawska	podwarszawski
podwarszawski	podwarszawski
podwarszawskich	podwarszawski
podwarszawskie	podwarszawski
podwarszawskiego	podwarszawski
podwarszawskiej	podwarszawski
podwarszawskiemu	podwarszawski
podwarszawskim	podwarszawski
podwarszawskimi	podwarszawski
podzamojscy	podzamojski
podzamojska	podzamojski
podzamojski	podzamojski
podzamojskich	podzamojski
podzamojskie	podzamojski
podzamojskiego	podzamojski
podzamojskiej	podzamojski
podzamojskiemu	podzamojski
podzamojskim	podzamojski
podzamojskimi	podzamojski
polanicy-zdrojowi	polanica-zdrój
polanicy-zdroju	polanica-zdrój
den policen	police
der police	police
der policen	police
die police	police
die policen	police
polic	police
policach	police
policami	police
police	police
policom	police
polkowic	polkowice
polkowicach	polkowice
polkowicami	polkowice
polkowice	polkowice
polkowicom	polkowice
polkowiccy	polkowicki
polkowicka	polkowicki
polkowicki	polkowicki
polkowickich	polkowicki
polkowickie	polkowicki
polkowickiego	polkowicki
polkowickiej	polkowicki
polkowickiemu	polkowicki
polkowickim	polkowicki
polkowickimi	polkowicki
polkowiczan	polkowiczanin
polkowiczanach	polkowiczanin
polkowiczanami	polkowiczanin
polkowiczanie	polkowiczanin
polkowiczanin	polkowiczanin
polkowiczanina	polkowiczanin
polkowiczaninem	polkowiczanin
polkowiczaninie	polkowiczanin
polkowiczaninowi	polkowiczanin
polkowiczanom	polkowiczanin
polkowiczance	polkowiczanka
polkowiczanek	polkowiczanka
polkowiczanka	polkowiczanka
polkowiczankach	polkowiczanka
polkowiczankami	polkowiczanka
polkowiczanki	polkowiczanka
polkowiczanko	polkowiczanka
polkowiczankom	polkowiczanka
poturczenia	poturczenie
poturczenie	poturczenie
poturczeniem	poturczenie
poturczeniu	poturczenie
poznania	poznań
poznaniem	poznań
poznaniowi	poznań
poznaniu	poznań
przemkowa	przemków
przemkowem	przemków
przemkowie	przemków
przemkowowi	przemków
przemkowian	przemkowianin
przemkowianach	przemkowianin
przemkowianami	przemkowianin
przemkowianie	przemkowianin
przemkowianin	przemkowianin
przemkowianina	przemkowianin
przemkowianinem	przemkowianin
przemkowianinie	przemkowianin
przemkowianom	przemkowianin
przemkowiance	przemkowianka
przemkowianek	przemkowianka
przemkowianka	przemkowianka
przemkowiankach	przemkowianka
przemkowiankami	przemkowianka
przemkowianki	przemkowianka
przemkowianko	przemkowianka
przemkowiankom	przemkowianka
przemkowscy	przemkowski
przemkowska	przemkowski
przemkowski	przemkowski
przemkowskich	przemkowski
przemkowskie	przemkowski
przemkowskiego	przemkowski
przemkowskiej	przemkowski
przemkowskiemu	przemkowski
przemkowskim	przemkowski
przemkowskimi	przemkowski
przemyscy	przemyski
przemyska	przemyski
przemyski	przemyski
przemyskich	przemyski
przemyskie	przemyski
przemyskiego	przemyski
przemyskiej	przemyski
przemyskiemu	przemyski
przemyskim	przemyski
przemyskimi	przemyski
pszowa	pszów
pszowem	pszów
pszowie	pszów
pszowowi	pszów
pszczyna	pszczyna
pszczynie	pszczyna
pszczyno	pszczyna
pszczyny	pszczyna
pszowscy	pszowski
pszowska	pszowski
pszowski	pszowski
pszowskich	pszowski
pszowskie	pszowski
pszowskiego	pszowski
pszowskiej	pszowski
pszowskiemu	pszowski
pszowskim	pszowski
pszowskimi	pszowski
puck	puck
pucka	puck
puckiem	puck
puckowi	puck
pucku	puck
puccy	pucki
pucka	pucki
pucki	pucki
puckich	pucki
puckie	pucki
puckiego	pucki
puckiej	pucki
puckiemu	pucki
puckim	pucki
puckimi	pucki
najpuccy	pucki
najpucka	pucki
najpucki	pucki
najpuckich	pucki
najpuckie	pucki
najpuckiego	pucki
najpuckiej	pucki
najpuckiemu	pucki
najpuckim	pucki
najpuckimi	pucki
puccy	pucki
pucka	pucki
pucki	pucki
puckich	pucki
puckie	pucki
puckiego	pucki
puckiej	pucki
puckiemu	pucki
puckim	pucki
puckimi	pucki
pyrzyc	pyrzyce
pyrzycach	pyrzyce
pyrzycami	pyrzyce
pyrzyce	pyrzyce
pyrzycom	pyrzyce
raciborza	racibórz
raciborzem	racibórz
raciborzowi	racibórz
raciborzu	racibórz
raciborscy	raciborski
raciborska	raciborski
raciborski	raciborski
raciborskich	raciborski
raciborskie	raciborski
raciborskiego	raciborski
raciborskiej	raciborski
raciborskiemu	raciborski
raciborskim	raciborski
raciborskimi	raciborski
raciborzan	raciborzanin
raciborzanach	raciborzanin
raciborzanami	raciborzanin
raciborzanie	raciborzanin
raciborzanin	raciborzanin
raciborzanina	raciborzanin
raciborzaninem	raciborzanin
raciborzaninie	raciborzanin
raciborzaninowi	raciborzanin
raciborzanom	raciborzanin
raciborzance	raciborzanka
raciborzanek	raciborzanka
raciborzanka	raciborzanka
raciborzankach	raciborzanka
raciborzankami	raciborzanka
raciborzanki	raciborzanka
raciborzanko	raciborzanka
raciborzankom	raciborzanka
radom	radom
radomia	radom
radomiach	radom
radomiami	radom
radomie	radom
radomiem	radom
radomiom	radom
radomiowi	radom
radomiu	radom
radomscy	radomski
radomska	radomski
radomski	radomski
radomskich	radomski
radomskie	radomski
radomskiego	radomski
radomskiej	radomski
radomskiemu	radomski
radomskim	radomski
radomskimi	radomski
radomska	radomsko
radomskiem	radomsko
radomsko	radomsko
radomsku	radomsko
reda	reda
redo	reda
redy	reda
redzie	reda
rud	ruda
ruda	ruda
rudach	ruda
rudami	ruda
rudom	ruda
rudy	ruda
rudzie	ruda
rumi	rumia
rumia	rumia
rumio	rumia
rybnik	rybnik
rybnika	rybnik
rybnikiem	rybnik
rybnikowi	rybnik
rybniku	rybnik
rzecz	rzecz
rzeczach	rzecz
rzeczami	rzecz
rzeczom	rzecz
rzeczy	rzecz
rzeszowa	rzeszów
rzeszowem	rzeszów
rzeszowie	rzeszów
rzeszowowi	rzeszów
rzeszowian	rzeszowianin
rzeszowianach	rzeszowianin
rzeszowianami	rzeszowianin
rzeszowianie	rzeszowianin
rzeszowianin	rzeszowianin
rzeszowianina	rzeszowianin
rzeszowianinem	rzeszowianin
rzeszowianinie	rzeszowianin
rzeszowianinowi	rzeszowianin
rzeszowianom	rzeszowianin
rzeszowiance	rzeszowianka
rzeszowianek	rzeszowianka
rzeszowianka	rzeszowianka
rzeszowiankach	rzeszowianka
rzeszowiankami	rzeszowianka
rzeszowianki	rzeszowianka
rzeszowianko	rzeszowianka
rzeszowiankom	rzeszowianka
rzeszowscy	rzeszowski
rzeszowska	rzeszowski
rzeszowski	rzeszowski
rzeszowskich	rzeszowski
rzeszowskie	rzeszowski
rzeszowskiego	rzeszowski
rzeszowskiej	rzeszowski
rzeszowskiemu	rzeszowski
rzeszowskim	rzeszowski
rzeszowskimi	rzeszowski
rzeszowszczyzna	rzeszowszczyzna
rzeszowszczyzno	rzeszowszczyzna
rzeszowszczyzny	rzeszowszczyzna
sandomierscy	sandomierski
sandomierska	sandomierski
sandomierski	sandomierski
sandomierskich	sandomierski
sandomierskie	sandomierski
sandomierskiego	sandomierski
sandomierskiej	sandomierski
sandomierskiemu	sandomierski
sandomierskim	sandomierski
sandomierskimi	sandomierski
sandomierz	sandomierz
sandomierza	sandomierz
sandomierzem	sandomierz
sandomierzowi	sandomierz
sandomierzu	sandomierz
sanocka	sanocka
sanockie	sanocka
sanockiej	sanocka
sanoccy	sanocki
sanoccy	sanocki
sanocka	sanocki
sanocki	sanocki
sanocki	sanocki
sanockich	sanocki
sanockich	sanocki
sanockie	sanocki
sanockiego	sanocki
sanockiego	sanocki
sanockiej	sanocki
sanockiemu	sanocki
sanockiemu	sanocki
sanockim	sanocki
sanockim	sanocki
sanockimi	sanocki
sanockimi	sanocki
sanok	sanok
sanoka	sanok
sanokach	sanok
sanokami	sanok
sanoki	sanok
sanokiem	sanok
sanokom	sanok
sanokowi	sanok
sanokowie	sanok
sanoku	sanok
siedlcach	siedlce
siedlcami	siedlce
siedlce	siedlce
siedlcom	siedlce
siedlec	siedlce
siemianowic	siemianowice
siemianowicach	siemianowice
siemianowicami	siemianowice
siemianowice	siemianowice
siemianowicom	siemianowice
siemianowiccy	siemianowicki
siemianowicka	siemianowicki
siemianowicki	siemianowicki
siemianowickich	siemianowicki
siemianowickie	siemianowicki
siemianowickiego	siemianowicki
siemianowickiej	siemianowicki
siemianowickiemu	siemianowicki
siemianowickim	siemianowicki
siemianowickimi	siemianowicki
najsiemianowiccy	siemianowicki
najsiemianowicka	siemianowicki
najsiemianowicki	siemianowicki
najsiemianowickich	siemianowicki
najsiemianowickie	siemianowicki
najsiemianowickiego	siemianowicki
najsiemianowickiej	siemianowicki
najsiemianowickiemu	siemianowicki
najsiemianowickim	siemianowicki
najsiemianowickimi	siemianowicki
siemianowiccy	siemianowicki
siemianowicka	siemianowicki
siemianowicki	siemianowicki
siemianowickich	siemianowicki
siemianowickie	siemianowicki
siemianowickiego	siemianowicki
siemianowickiej	siemianowicki
siemianowickiemu	siemianowicki
siemianowickim	siemianowicki
siemianowickimi	siemianowicki
siemianowiczan	siemianowiczanin
siemianowiczanach	siemianowiczanin
siemianowiczanami	siemianowiczanin
siemianowiczanie	siemianowiczanin
siemianowiczanin	siemianowiczanin
siemianowiczanina	siemianowiczanin
siemianowiczaninem	siemianowiczanin
siemianowiczaninie	siemianowiczanin
siemianowiczaninowi	siemianowiczanin
siemianowiczanom	siemianowiczanin
siemianowiczance	siemianowiczanka
siemianowiczanek	siemianowiczanka
siemianowiczanka	siemianowiczanka
siemianowiczankach	siemianowiczanka
siemianowiczankami	siemianowiczanka
siemianowiczanki	siemianowiczanka
siemianowiczanko	siemianowiczanka
siemianowiczankom	siemianowiczanka
sieradz	sieradz
sieradza	sieradz
sieradzem	sieradz
sieradzowi	sieradz
sieradzu	sieradz
skawina	skawina
skawinie	skawina
skawino	skawina
skawiny	skawina
skoczowa	skoczów
skoczowem	skoczów
skoczowie	skoczów
skoczowowi	skoczów
sopoccy	sopocki
sopocka	sopocki
sopocki	sopocki
sopockich	sopocki
sopockie	sopocki
sopockiego	sopocki
sopockiej	sopocki
sopockiemu	sopocki
sopockim	sopocki
sopockimi	sopocki
najsopoccy	sopocki
najsopocka	sopocki
najsopocki	sopocki
najsopockich	sopocki
najsopockie	sopocki
najsopockiego	sopocki
najsopockiej	sopocki
najsopockiemu	sopocki
najsopockim	sopocki
najsopockimi	sopocki
sopoccy	sopocki
sopocka	sopocki
sopocki	sopocki
sopockich	sopocki
sopockie	sopocki
sopockiego	sopocki
sopockiej	sopocki
sopockiemu	sopocki
sopockim	sopocki
sopockimi	sopocki
sopocie	sopot
sopot	sopot
sopotach	sopot
sopotami	sopot
sopotem	sopot
sopotom	sopot
sopotowi	sopot
sopotu	sopot
sopoty	sopot
sosen	sosna
sosna	sosna
sosnach	sosna
sosnami	sosna
sosno	sosna
sosnom	sosna
sosnou	sosna
sosnu	sosna
sosny	sosna
sosnowiczan	sosnowiczanin
sosnowiczanach	sosnowiczanin
sosnowiczanami	sosnowiczanin
sosnowiczanie	sosnowiczanin
sosnowiczanin	sosnowiczanin
sosnowiczanina	sosnowiczanin
sosnowiczaninem	sosnowiczanin
sosnowiczaninie	sosnowiczanin
sosnowiczaninowi	sosnowiczanin
sosnowiczanom	sosnowiczanin
sosnowiczance	sosnowiczanka
sosnowiczanek	sosnowiczanka
sosnowiczanka	sosnowiczanka
sosnowiczankach	sosnowiczanka
sosnowiczankami	sosnowiczanka
sosnowiczanki	sosnowiczanka
sosnowiczanko	sosnowiczanka
sosnowiczankom	sosnowiczanka
sosnowca	sosnowiec
sosnowcach	sosnowiec
sosnowcami	sosnowiec
sosnowce	sosnowiec
sosnowcem	sosnowiec
sosnowcom	sosnowiec
sosnowcowi	sosnowiec
sosnowcu	sosnowiec
sosnowiec	sosnowiec
sosnowieccy	sosnowiecki
sosnowiecka	sosnowiecki
sosnowiecki	sosnowiecki
sosnowieckich	sosnowiecki
sosnowieckie	sosnowiecki
sosnowieckiego	sosnowiecki
sosnowieckiej	sosnowiecki
sosnowieckiemu	sosnowiecki
sosnowieckim	sosnowiecki
sosnowieckimi	sosnowiecki
sosnowa	sosnowy
sosnowe	sosnowy
sosnowego	sosnowy
sosnowej	sosnowy
sosnowemu	sosnowy
sosnowi	sosnowy
sosnowy	sosnowy
sosnowych	sosnowy
sosnowym	sosnowy
sosnowymi	sosnowy
stalowa wola	stalowa wola
stalowa wolo	stalowa wola
stalowej woli	stalowa wola
stalowowolscy	stalowowolski
stalowowolska	stalowowolski
stalowowolski	stalowowolski
stalowowolskich	stalowowolski
stalowowolskie	stalowowolski
stalowowolskiego	stalowowolski
stalowowolskiej	stalowowolski
stalowowolskiemu	stalowowolski
stalowowolskim	stalowowolski
stalowowolskimi	stalowowolski
star	star
star / stara	star
stara	star
starach	star
starami	star
starem	star
starom	star
starowi	star
stary	star
starze	star
starachowic	starachowice
starachowicach	starachowice
starachowicami	starachowice
starachowice	starachowice
starachowicom	starachowice
starachowiccy	starachowicki
starachowicka	starachowicki
starachowicki	starachowicki
starachowickich	starachowicki
starachowickie	starachowicki
starachowickiego	starachowicki
starachowickiej	starachowicki
starachowickiemu	starachowicki
starachowickim	starachowicki
starachowickimi	starachowicki
sucha beskidzka	sucha beskidzka
suchej beskidzkiej	sucha beskidzka
szczebrzeszyn	szczebrzeszyn
szczebrzeszyna	szczebrzeszyn
szczebrzeszynem	szczebrzeszyn
szczebrzeszynie	szczebrzeszyn
szczebrzeszynowi	szczebrzeszyn
szczecin	szczecin
szczecina	szczecin
szczecinem	szczecin
szczecinie	szczecin
szczecinowi	szczecin
szczecinek	szczecinek
szczecinka	szczecinek
szczecinkiem	szczecinek
szczecinkowi	szczecinek
szczecinku	szczecinek
szczyrk	szczyrk
szczyrkiem	szczyrk
szczyrkowi	szczyrk
szczyrku	szczyrk
tarnobrzeg	tarnobrzeg
tarnobrzegiem	tarnobrzeg
tarnobrzegowi	tarnobrzeg
tarnobrzegu	tarnobrzeg
tarnobrzescy	tarnobrzeski
tarnobrzeska	tarnobrzeski
tarnobrzeski	tarnobrzeski
tarnobrzeskich	tarnobrzeski
tarnobrzeskie	tarnobrzeski
tarnobrzeskiego	tarnobrzeski
tarnobrzeskiej	tarnobrzeski
tarnobrzeskiemu	tarnobrzeski
tarnobrzeskim	tarnobrzeski
tarnobrzeskimi	tarnobrzeski
tarnowian	tarnowianin
tarnowianach	tarnowianin
tarnowianami	tarnowianin
tarnowianie	tarnowianin
tarnowianin	tarnowianin
tarnowianina	tarnowianin
tarnowianinem	tarnowianin
tarnowianinie	tarnowianin
tarnowianinowi	tarnowianin
tarnowianom	tarnowianin
tarnowscy	tarnowski
tarnowska	tarnowski
tarnowski	tarnowski
tarnowskich	tarnowski
tarnowskie	tarnowski
tarnowskiego	tarnowski
tarnowskiej	tarnowski
tarnowskiemu	tarnowski
tarnowskim	tarnowski
tarnowskimi	tarnowski
tczew	tczew
tczewem	tczew
tczewie	tczew
tczewowi	tczew
terespol	terespol
terespolach	terespol
terespolami	terespol
terespole	terespol
terespolem	terespol
terespoli	terespol
terespolom	terespol
terespolowi	terespol
terespolu	terespol
terespolan	terespolanin
terespolanach	terespolanin
terespolanami	terespolanin
terespolanie	terespolanin
terespolanin	terespolanin
terespolanina	terespolanin
terespolaninem	terespolanin
terespolaninie	terespolanin
terespolaninowi	terespolanin
terespolanom	terespolanin
terespolance	terespolanka
terespolanek	terespolanka
terespolanka	terespolanka
terespolankach	terespolanka
terespolankami	terespolanka
terespolanki	terespolanka
terespolanko	terespolanka
terespolankom	terespolanka
terespolscy	terespolski
terespolska	terespolski
terespolski	terespolski
terespolskich	terespolski
terespolskie	terespolski
terespolskiego	terespolski
terespolskiej	terespolski
terespolskiemu	terespolski
terespolskim	terespolski
terespolskimi	terespolski
tomaszowa lubelskiego	tomaszów lubelski
tomaszowem lubelskim	tomaszów lubelski
tomaszowie lubelski	tomaszów lubelski
tomaszowie lubelskim	tomaszów lubelski
tomaszowowi lubelskiemu	tomaszów lubelski
tomaszowa mazowieckiego	tomaszów mazowiecki
tomaszowem mazowieckim	tomaszów mazowiecki
tomaszowie mazowiecki	tomaszów mazowiecki
tomaszowie mazowieckim	tomaszów mazowiecki
tomaszowowi mazowieckiemu	tomaszów mazowiecki
torunia	toruń
toruniem	toruń
toruniowi	toruń
toruniu	toruń
trzebiatowa	trzebiatów
trzebiatowem	trzebiatów
trzebiatowie	trzebiatów
trzebiatowowi	trzebiatów
tucholscy	tucholski
tucholska	tucholski
tucholski	tucholski
tucholskich	tucholski
tucholskie	tucholski
tucholskiego	tucholski
tucholskiej	tucholski
tucholskiemu	tucholski
tucholskim	tucholski
tucholskimi	tucholski
turcja	turcja
turcji	turcja
turcjo	turcja
turcyzm	turcyzm
turcyzmach	turcyzm
turcyzmami	turcyzm
turcyzmem	turcyzm
turcyzmom	turcyzm
turcyzmowi	turcyzm
turcyzmu	turcyzm
turcyzmy	turcyzm
turczynce	turczynka
turczynek	turczynka
turczynka	turczynka
turczynkach	turczynka
turczynkami	turczynka
turczynki	turczynka
turczynko	turczynka
turczynkom	turczynka
tureccy	turecki
turecka	turecki
turecki	turecki
tureckich	turecki
tureckie	turecki
tureckiego	turecki
tureckiej	turecki
tureckiemu	turecki
tureckim	turecki
tureckimi	turecki
precyzja	turek
przejrzana	turek
turcy	turek
turek	turek
turka	turek
turka / turku	turek
turkach	turek
turkami	turek
turki	turek
turkiem	turek
turkom	turek
turkowi	turek
turkowie	turek
turku	turek
turkijscy	turkijski
turkijska	turkijski
turkijski	turkijski
turkijskich	turkijski
turkijskie	turkijski
turkijskiego	turkijski
turkijskiej	turkijski
turkijskiemu	turkijski
turkijskim	turkijski
turkijskimi	turkijski
turkizacja	turkizacja
turkizacji	turkizacja
turkizacjo	turkizacja
tychach	tychy
tychami	tychy
tychom	tychy
tychy	tychy
tyscy	tyski
tyska	tyski
tyski	tyski
tyskich	tyski
tyskie	tyski
tyskiego	tyski
tyskiej	tyski
tyskiemu	tyski
tyskim	tyski
tyskimi	tyski
tyszance	tyszanka
tyszanek	tyszanka
tyszanka	tyszanka
tyszankach	tyszanka
tyszankami	tyszanka
tyszanki	tyszanka
tyszanko	tyszanka
tyszankom	tyszanka
ustczan	ustczanin
ustczanach	ustczanin
ustczanami	ustczanin
ustczanie	ustczanin
ustczanin	ustczanin
ustczanina	ustczanin
ustczaninem	ustczanin
ustczaninie	ustczanin
ustczaninowi	ustczanin
ustczanom	ustczanin
ustczance	ustczanka
ustczanek	ustczanka
ustczanka	ustczanka
ustczankach	ustczanka
ustczankami	ustczanka
ustczanki	ustczanka
ustczanko	ustczanka
ustczankom	ustczanka
usteccy	ustecki
ustecka	ustecki
ustecki	ustecki
usteckich	ustecki
usteckie	ustecki
usteckiego	ustecki
usteckiej	ustecki
usteckiemu	ustecki
usteckim	ustecki
usteckimi	ustecki
ustce	ustka
ustka	ustka
ustki	ustka
ustko	ustka
ustronia	ustroń
ustroniem	ustroń
ustroniowi	ustroń
ustroniu	ustroń
ustrzyk dolnych	ustrzyki dolne
ustrzykach dolnych	ustrzyki dolne
ustrzykami dolnymi	ustrzyki dolne
ustrzyki dolne	ustrzyki dolne
ustrzykom dolnym	ustrzyki dolne
wadowic	wadowice
wadowicach	wadowice
wadowicami	wadowice
wadowice	wadowice
wadowicom	wadowice
wadowiccy	wadowicki
wadowicka	wadowicki
wadowicki	wadowicki
wadowickich	wadowicki
wadowickie	wadowicki
wadowickiego	wadowicki
wadowickiej	wadowicki
wadowickiemu	wadowicki
wadowickim	wadowicki
wadowickimi	wadowicki
wadowiczan	wadowiczanin
wadowiczanach	wadowiczanin
wadowiczanami	wadowiczanin
wadowiczanie	wadowiczanin
wadowiczanin	wadowiczanin
wadowiczanina	wadowiczanin
wadowiczaninem	wadowiczanin
wadowiczaninie	wadowiczanin
wadowiczaninowi	wadowiczanin
wadowiczanom	wadowiczanin
wadowiczance	wadowiczanka
wadowiczanek	wadowiczanka
wadowiczanka	wadowiczanka
wadowiczankach	wadowiczanka
wadowiczankami	wadowiczanka
wadowiczanki	wadowiczanka
wadowiczanko	wadowiczanka
wadowiczankom	wadowiczanka
warszaw	warszawa
warszaw	warszawa
warszawa	warszawa
warszawa	warszawa
warszawach	warszawa
warszawach	warszawa
warszawami	warszawa
warszawami	warszawa
warszawianin	warszawa
warszawie	warszawa
warszawie	warszawa
warszawo	warszawa
warszawo	warszawa
warszawom	warszawa
warszawom	warszawa
warszawy	warszawa
warszawy	warszawa
warszawiacy	warszawiak
warszawiak	warszawiak
warszawiaka	warszawiak
warszawiakach	warszawiak
warszawiakami	warszawiak
warszawiakiem	warszawiak
warszawiakom	warszawiak
warszawiakowi	warszawiak
warszawiaku	warszawiak
warszawian	warszawianin
warszawianach	warszawianin
warszawianami	warszawianin
warszawianie	warszawianin
warszawianin	warszawianin
warszawianina	warszawianin
warszawianinem	warszawianin
warszawianinie	warszawianin
warszawianinowi	warszawianin
warszawianom	warszawianin
warszawiance	warszawianka
warszawianek	warszawianka
warszawianka	warszawianka
warszawiankach	warszawianka
warszawiankami	warszawianka
warszawianki	warszawianka
warszawianko	warszawianka
warszawiankom	warszawianka
warszawce	warszawka
warszawek	warszawka
warszawka	warszawka
warszawkach	warszawka
warszawkami	warszawka
warszawki	warszawka
warszawko	warszawka
warszawkom	warszawka
warszawscy	warszawski
warszawska	warszawski
warszawski	warszawski
warszawskich	warszawski
warszawskie	warszawski
warszawskiego	warszawski
warszawskiej	warszawski
warszawskiemu	warszawski
warszawskim	warszawski
warszawskimi	warszawski
wejherowa	wejherowo
wejherowem	wejherowo
wejherowie	wejherowo
wejherowo	wejherowo
wejherowu	wejherowo
wieliccy	wielicki
wielicka	wielicki
wielicki	wielicki
wielickich	wielicki
wielickie	wielicki
wielickiego	wielicki
wielickiej	wielicki
wielickiemu	wielicki
wielickim	wielicki
wielickimi	wielicki
wielunia	wieluń
wieluniach	wieluń
wieluniami	wieluń
wielunie	wieluń
wieluniem	wieluń
wieluniom	wieluń
wieluniowi	wieluń
wieluniu	wieluń
wielunian	wielunianin
wielunianach	wielunianin
wielunianami	wielunianin
wielunianie	wielunianin
wielunianin	wielunianin
wielunianina	wielunianin
wielunianinem	wielunianin
wielunianinie	wielunianin
wielunianinowi	wielunianin
wielunianom	wielunianin
wieluniance	wielunianka
wielunianek	wielunianka
wielunianka	wielunianka
wieluniankach	wielunianka
wieluniankami	wielunianka
wielunianki	wielunianka
wielunianko	wielunianka
wieluniankom	wielunianka
wieruszowa	wieruszów
wieruszowem	wieruszów
wieruszowie	wieruszów
wieruszowowi	wieruszów
wolbrom	wolbrom
wolbromia	wolbrom
wolbromiem	wolbrom
wolbromiowi	wolbrom
wolbromiu	wolbrom
wolbromian	wolbromianin
wolbromianach	wolbromianin
wolbromianami	wolbromianin
wolbromianie	wolbromianin
wolbromianin	wolbromianin
wolbromianina	wolbromianin
wolbromianinem	wolbromianin
wolbromianinie	wolbromianin
wolbromianinowi	wolbromianin
wolbromianom	wolbromianin
wolbromiance	wolbromianka
wolbromianek	wolbromianka
wolbromianka	wolbromianka
wolbromiankach	wolbromianka
wolbromiankami	wolbromianka
wolbromianki	wolbromianka
wolbromianko	wolbromianka
wolbromiankom	wolbromianka
wolbromscy	wolbromski
wolbromska	wolbromski
wolbromski	wolbromski
wolbromskich	wolbromski
wolbromskie	wolbromski
wolbromskiego	wolbromski
wolbromskiej	wolbromski
wolbromskiemu	wolbromski
wolbromskim	wolbromski
wolbromskimi	wolbromski
wron	wrona
wrona	wrona
wronach	wrona
wronami	wrona
wrono	wrona
wronom	wrona
wrony	wrona
wroni	wroni
wronia	wroni
wronich	wroni
wronie	wroni
wroniego	wroni
wroniej	wroni
wroniemu	wroni
wronim	wroni
wronimi	wroni
wronce	wronka
wronce	wronka
wronek	wronka
wronek	wronka
wronka	wronka
wronka	wronka
wronkach	wronka
wronkach	wronka
wronkami	wronka
wronkami	wronka
wronki	wronka
wronki	wronka
wronko	wronka
wronko	wronka
wronkom	wronka
wronkom	wronka
wschowa	wschowa
wschowie	wschowa
wschowo	wschowa
wschowy	wschowa
zabrza	zabrze
zabrze	zabrze
zabrzem	zabrze
zabrzu	zabrze
zakopane	zakopane
zakopanego	zakopane
zakopanemu	zakopane
zakopiance	zakopianka
zakopiance	zakopianka
zakopianek	zakopianka
zakopianka	zakopianka
zakopianka	zakopianka
zakopiankach	zakopianka
zakopiankami	zakopianka
zakopianki	zakopianka
zakopianki	zakopianka
zakopianko	zakopianka
zakopianko	zakopianka
zakopiankom	zakopianka
zamojscy	zamojski
zamojska	zamojski
zamojski	zamojski
zamojskich	zamojski
zamojskie	zamojski
zamojskiego	zamojski
zamojskiej	zamojski
zamojskiemu	zamojski
zamojskim	zamojski
zamojskimi	zamojski
zamojszczyzna	zamojszczyzna
zamojszczyzno	zamojszczyzna
zamojszczyzny	zamojszczyzna
zawiercia	zawiercie
zawiercie	zawiercie
zawierciem	zawiercie
zawierciu	zawiercie
zdzieszowic	zdzieszowice
zdzieszowicach	zdzieszowice
zdzieszowicami	zdzieszowice
zdzieszowice	zdzieszowice
zdzieszowicom	zdzieszowice
zgierscy	zgierski
zgierska	zgierski
zgierski	zgierski
zgierskich	zgierski
zgierskie	zgierski
zgierskiego	zgierski
zgierskiej	zgierski
zgierskiemu	zgierski
zgierskim	zgierski
zgierskimi	zgierski
zgierz	zgierz
zgierza	zgierz
zgierzem	zgierz
zgierzowi	zgierz
zgierzu	zgierz
zgierzan	zgierzanin
zgierzanach	zgierzanin
zgierzanami	zgierzanin
zgierzanie	zgierzanin
zgierzanin	zgierzanin
zgierzanina	zgierzanin
zgierzaninem	zgierzanin
zgierzaninie	zgierzanin
zgierzaninowi	zgierzanin
zgierzanom	zgierzanin
zgierzance	zgierzanka
zgierzanek	zgierzanka
zgierzanka	zgierzanka
zgierzankach	zgierzanka
zgierzankami	zgierzanka
zgierzanki	zgierzanka
zgierzanko	zgierzanka
zgierzankom	zgierzanka
zielenin	zielenina
zielenina	zielenina
zieleninach	zielenina
zieleninami	zielenina
zieleninie	zielenina
zielenino	zielenina
zieleninom	zielenina
zieleniny	zielenina
zieloniutcy	zieloniutki
zieloniutka	zieloniutki
zieloniutki	zieloniutki
zieloniutkich	zieloniutki
zieloniutkie	zieloniutki
zieloniutkiego	zieloniutki
zieloniutkiej	zieloniutki
zieloniutkiemu	zieloniutki
zieloniutkim	zieloniutki
zieloniutkimi	zieloniutki
zielonce	zielonka
zielonek	zielonka
zielonka	zielonka
zielonkach	zielonka
zielonkami	zielonka
zielonki	zielonka
zielonko	zielonka
zielonkom	zielonka
zielonkowie	zielonka
zielonkawa	zielonkawy
zielonkawe	zielonkawy
zielonkawego	zielonkawy
zielonkawej	zielonkawy
zielonkawemu	zielonkawy
zielonkawi	zielonkawy
zielonkawy	zielonkawy
zielonkawych	zielonkawy
zielonkawym	zielonkawy
zielonkawymi	zielonkawy
najzielonkawa	zielonkawy
najzielonkawe	zielonkawy
najzielonkawego	zielonkawy
najzielonkawej	zielonkawy
najzielonkawemu	zielonkawy
najzielonkawi	zielonkawy
najzielonkawy	zielonkawy
najzielonkawych	zielonkawy
najzielonkawym	zielonkawy
najzielonkawymi	zielonkawy
zielonkawa	zielonkawy
zielonkawe	zielonkawy
zielonkawego	zielonkawy
zielonkawej	zielonkawy
zielonkawemu	zielonkawy
zielonkawi	zielonkawy
zielonkawy	zielonkawy
zielonkawych	zielonkawy
zielonkawym	zielonkawy
zielonkawymi	zielonkawy
zielona	zielony
zielone	zielony
zielonego	zielony
zielonej	zielony
zielonemu	zielony
zieloni	zielony
zielony	zielony
zielonych	zielony
zielonym	zielony
zielonymi	zielony