sanoczanin	sanok
zielonkowy	zielonka
zamojszczyzna	zamość
sieradzanin	sieradz
poznaniak	poznań
opolszczyzna	opole
augustianka	augustów
czerski	czersk
zielonkowa	zielonka
podsosnowiecki	sosnowiec
orzeszanka	orzesze
oborniki	oborniki śląskie
raciborski	racibórz
krasnostawianka	krasnystaw
radomszczanka	radom
rybnik	rybnik
piszanka	pisz
gniewianka	gniew
brodniczanin	brodnica
trzebiatowski	trzebiatów
buskowianka	busko-zdrój
bochnianin	bochnia
mielecki	mielec
nowogardzki	nowogard
radomsk	radomsko
trzebiatowianka	trzebiatów
podkatowicki	katowice
duszniczanka	duszniki-zdrój
zgierzanin	zgierz
zielenienie	zielonka
warszawa	warszawa
zawiercianin	zawiercie
rzeszowszczyzna	rzeszów
krapkowicki	krapkowice
wolbromianka	wolbrom
grodziszczanin	grodzisk wielkopolski
terespolanin	terespol
boguszowianka	boguszów-gorce
krakowiak	kraków
bielszczanin	bielsko-biała
gliwiczanin	gliwice
nyska	nysa
piekarski	piekary śląskie
turcyzm	turek
kolbuszowianin	kolbuszowa
wschowski	wschowa
starachowicki	starachowice
goleniowski	goleniów
wolbromski	wolbrom
nyski	nysa
zielony	zielonka
warczanka	warka
rudzianin	ruda Śląska
skoczowski	skoczów
zamojski	zamość
bielawianka	bielawa
wyszkowianka	wyszków
kozienicki	kozienice
kazimierzanin	kazimierz dolny
zielenina	zielonka
krzepiczanin	krzepice
stalowowolanka	stalowa wola
bytomianin	bytom
koninianka	konin
lubelszczyzna	lublin
bielszczanka	bielsko-biała
barlinecki	barlinek
tyski	tychy
wadowiczanin	wadowice
tychowianka	tychy
kutnianka	kutno
starachowiczanin	starachowice
jarek	jarosław
podprzemyski	przemyśl
podbytomski	bytom
mosinianka	mosina
gorliczanka	gorlice
tucholski	tuchola
bydgoszczanka	bydgoszcz
turecczyzna	turek
katowiczanka	katowice
krakowianka	kraków
rybniczanka	rybnik
podlegnicki	legnica
kutnianin	kutno
bolkowianka	bolków
opolanka	opole
raciborzanka	racibórz
podpilski	piła
bytowianka	bytów
sanocki	sanok
noworudzianka	nowa ruda
krzeszowicki	krzeszowice
chorzowianka	chorzów
jastrowianin	jastrowie
gorlicki	gorlice
wejherowianka	wejherowo
augustowianka	augustów
pelplinianka	pelplin
podbrodnicki	brodnica
szczecinczanka	szczecinek
zabrzanin	zabrze
brzezina	brzozów
chorzowski	chorzów
sopocianka	sopot
nysa	nysa
pilanka	piła
pieszycki	pieszyce
skoczowianin	skoczów
legniczanka	legnica
zakopianka	zakopane
turczyn	turek
torunianin	toruń
turecko	turek
jareczek	jarosław
gorzowianka	gorzów wielkopolski
polkowiczanin	polkowice
szczebrzeszynianka	szczebrzeszyn
olecczanin	olecko
krakus	kraków
tczewski	tczew
barlinczanka	barlinek
malborczanka	malbork
pieszyczanka	pieszyce
jaras	jarosław
wrona	wronki
kartuzianin	kartuzy
wroni	wronki
bogatynianka	bogatynia
biskup	biskupiec
polanicki	polanica-zdrój
sosnowy	sosnowiec
podzamojski	zamość
gawron	wronki
tomaszowianka	tomaszów mazowiecki
ustronianin	ustroń
bydgoski	bydgoszcz
hajnowianka	hajnówka
krzeszowiczanka	krzeszowice
skawinianka	skawina
warszawka	warszawa
polaniczanin	polanica-zdrój
kryniczny	krynica
blachownianka	blachownia
opolanin	opole
forma	turek
pszczynianka	pszczyna
rybnicki	rybnik
siedlecki	siedlce
przym	myślibórz
wronka	wronki
podtarnowski	tarnów
sandomierzanin	sandomierz
brzoza	brzozów
poznanianka	poznań
malborski	malbork
pabianicki	pabianice
terespolski	terespol
kielczanka	kielce
jaworski	jawor
policzaninpoliczanka	police
fmos	bartoszyce
torunianka	toruń
podstalowowolski	stalowa wola
pszczynianin	pszczyna
pyrzyczaninpyrzyczanka	pyrzyce
radomski	radom
piekarzanka	piekary śląskie
pucki	puck
olsztynianka	olsztyn
tarnobrzeski	tarnobrzeg
augustyn	augustów
kolski	koło
gdynianka	gdynia
lesznianka	leszno
krzepicki	krzepice
olkuszanka	olkusz
bydgoszczak	bydgoszcz
jaworznianka	jaworzno
bartoszyczanka	bartoszyce
sanocka	sanok
kaliski	kalisz
kolanka	koło
gubinianin	gubin
podrzeszowski	rzeszów
brzeski	brzeg
cieszynianka	cieszyn
noworudzki	nowa ruda
krakowski	kraków
mielczanin	mielec
kaliszanka	kalisz
lubonianin	luboń
brzegowianka	brzeg
koluszkowski	koluszki
tczewianin	tczew
augustyniak	augustów
bolkowski	bolków
brzozowski	brzozów
hrubieszowianin	hrubieszów
braniewski	braniewo
radomierzyce	radomsko
wschowianin	wschowa
bielski	bielsko-biała
warszawka	warszawa
bartoszycki	bartoszyce
zgorzelczanka	zgorzelec
brzozowianka	brzozów
sosna	sosnowiec
wielunianka	wieluń
krapkowiczanin	krapkowice
goleniowianka	goleniów
polkowicki	polkowice
bierutowski	bierutów
sanoczanka	sanok
oborniczanka	oborniki śląskie
lubelskie	lublin
opolanin	opole
pianin	piła
szczecinczanin	szczecinek
pilecki	piła
wrocek	wrocław
radomianin	radom
gorliczanin	gorlice
siedlczanka	siedlce
ruda	ruda Śląska
gliwicki	gliwice
kolbuszowianka	kolbuszowa
buszczanka	busko-zdrój
brodniczanka	brodnica
chojnowianin	chojnów
podpabianicki	pabianice
radomskie	radom
makowianin	maków podhalański
podbydgoski	bydgoszcz
lubinianka	lubin
strzegomianin	strzegom
sandomierzanka	sandomierz
rudzki	ruda Śląska
krzepiczanka	krzepice
pyrzycki	pyrzyce
cieszynianin	cieszyn
wolbromianin	wolbrom
koszalinianka	koszalin
strzegomski	strzegom
rzeszowianka	rzeszów
lubliniecki	lubliniec
policki	police
warszawista	warszawa
nowosolski	nowa sól
zazielenienie	zielonka
jareczkowa	jarosław
szczecinecki	szczecinek
kolbuszowski	kolbuszowa
bartoszewski	bartoszyce
krakuska	kraków
kopacz	zakopane
cieszynit	cieszyn
kielczanin	kielce
siemianowiczanka	siemianowice śląskie
tyszanka	tychy
warczanin	warka
biskupi	biskupiec
pszowski	pszów
gniewianin	gniew
siemianowiczanin	siemianowice śląskie
buski	busko-zdrój
sieradzanka	sieradz
brzozowy	brzozów
piszanin	pisz
drezdenecki	drezdenko
bydgoskie	bydgoszcz
dusznicki	duszniki-zdrój
pyrzyczanie	pyrzyce
koniecpolanka	koniecpol
lublinianin	lublin
obornicki	oborniki Śląskie
biskupiecki	biskupiec
szczecinecczanka	szczecinek
radomszczanin	radomsko
legnicki	legnica
dobromiejski	dobre miasto
mrz	brzozów
brzezinianin	brzeziny
bochnianka	bochnia
lublin	lublin
rzeszowski	rzeszów
zakopianka	zakopane
warszawianka	warszawa
warszawiak	warszawa
lubliniak	lublin
piotrkowski	piotrków trybunalski
podkielecki	kielce
konecczanin	końskie
sosnowiczanin	sosnowiec
gryficzaningryficzanka	gryfice
jarkowa	jarosław
czechowicki	czechowice-dziedzice
wadowicki	wadowice
kalecki	kalety
tarnowianin	tarnów
nowotomyski	nowy tomyśl
podwadowicki	wadowice
kielecki	kielce
makowski	maków podhalański
turczy	turek
cieszyniaczka	cieszyn
mielczanka	mielec
gorzowski	gorzów wielkopolski
gliwy	gliwice
hajnowski	hajnówka
koninianin	konin
kielecczyzna	kielce
chojniczanka	chojnice
kutnowski	kutno
skoczowianka	skoczów
blaszany	blachownia
wadowiczanka	wadowice
zielonka	zielonka
starachowiczanka	starachowice
wyszkowianin	wyszków
bielawianin	bielawa
żywiecki	żywiec
bydgoszczan	bydgoszcz
sandomierszczyzna	sandomierz
zieloniutki	zielonka
podrybnicki	rybnik
sanoczek	sanok
jasielski	jasło
krakowianin	kraków
zielonkowy	zielonka
kazimierzanka	kazimierz dolny
bytomianka	bytom
cieszyniak	cieszyn
krasnostawianin	krasnystaw
lublinianin	lublin
obornik	oborniki
raciborzanin	racibórz
chojnowski	chojnów
orzeszanin	orzesze
lubelski	lublin
jastrowianka	jastrowie
piski	pisz
wieruszowianin	wieruszów
przemkowski	przemków
turkizacja	turek
trzebiatowianin	trzebiatów
radomiak	radom
lubartowianin	lubartów
krak	kraków
sandomierski	sandomierz
wejherowianin	wejherowo
bydgoszczanka	bydgoszcz
zabrzanka	zabrze
podopolski	opole
wejherowski	wejherowo
sopocianin	sopot
zgorzelecki	zgorzelec
warszawianin	warszawa
krzeszowiczanin	krzeszowice
terespolanka	terespol
cieszynitowy	cieszyn
wieruszowski	wieruszów
warszawski	warszawa
warecki	warka
brzozowski	brzozów
brzeziniak	brzozów
gorzowianin	gorzów wielkopolski
polkowiczanka	polkowice
szczebrzeszynianin	szczebrzeszyn
radomka	radomsko
gniewski	gniew
podgliwicki	gliwice
kazimierski	kazimierz dolny
pieszyczanin	pieszyce
olsztyniak	olsztyn
stalowowolanin	stalowa wola
konecki	końskie
augustowianin	augustów
krakowskie	kraków
ustrzycki	ustrzyki dolne
bielawski	bielawa
radomianka	radom
kaliszanin	kalisz
jawor	jawor
zgierski	zgierz
przemkowianka	przemków
mosinianin	mosina
jastrowski	jastrowie
tczewianka	tczew
katowiczanin	katowice
radomsko	radom
chorzowianin	chorzów
nowosolanin	nowa sól
mosmzw	zakopane
krasnostawski	krasnystaw
ustczanin	ustka
rybniczanin	rybnik
sandomierzanka	sandomierz
brzozowianin	brzozów
garwolinianka	garwolin
malborczanin	malbork
duszniczanin	duszniki-zdrój
zielonki	zielonka
radom	radomsko
noworudzianin	nowa ruda
zabrski	zabrze
poturczenie	turek
bytowianin	bytów
podwarszawski	warszawa
miech	miechów
pelplinianin	pelplin
siemianowicki	siemianowice śląskie
siemianowice	siemianowice śląskie
piekarzanin	piekary śląskie
bartoszewicz	bartoszyce
brodnicki	brodnica
gdynianin	gdynia
cieszynka	cieszyn
lesznianin	leszno
sopocki	sopot
tychowianin	tychy
stalowowolski	stalowa wola
legniczanin	legnica
olkuszanin	olkusz
opolski	opole
augustowski	augustów
jaworznianin	jaworzno
zielonkawy	zielonka
zakopianin	zakopane
zawiercianka	zawiercie
kolanin	koło
gubinianka	gubin
kielczanin	kielce
zdrobn	sanok
olkuski	olkusz
mos	piotrków trybunalski
barlinczanin	barlinek
krakowiaczek	kraków
ciech	cieszyn
racibor	racibórz
bogatynianin	bogatynia
lublinianka	lublin
brzezinianka	brzeziny
bydgoszczanin	bydgoszcz
helski	hel
olecczanka	olecko
ustronianka	ustroń
tomaszowianin	tomaszów mazowiecki
hajnowianin	hajnówka
piotrkowianka	piotrków trybunalski
ciechanowski	ciechanów
skawinianin	skawina
grodziszczanka	grodzisk wielkopolski
olecki	olecko
przemyski	przemyśl
polaniczanka	polanica-zdrój
wronka	wronki
blachownianin	blachownia
siedlczanin	siedlce
pilskie	piła
chojnowianka	chojnów
opolskie	opole
kieleckie	kielce
wielicki	wieliczka
zielona	zielona góra
grodziski	grodzisk wielkopolski
hrubieszowianka	hrubieszów
turcja	turek
turczyn	turek
chodzieski	chodzież
brzeg	brzeg
wronkowski	wronki
turecki	turek
bialskopodlaskie	biała podlaska
bialskopodlaski	biała podlaska
poznanianin	poznań
malborka	malbork
podraciborski	racibórz
tarnowianka	tarnów
wroniecki	wronki
sosnowiecki	sosnowiec
kowarski	kowary
sieradzki	sieradz
hrubieszowski	hrubieszów
gliwiczanka	gliwice
rzeszowianin	rzeszów
orzeski	orzesze
makowianka	maków podhalański
tarnowski	tarnów
lubinianin	lubin
szczecinecczanin	szczecinek
tomaszowski	tomaszów mazowiecki
zgrub	jarosław
malborczyk	malbork
kielczanka	kielce
gniew	gniew
nowosolanka	nowa sól
boguszowski	boguszów-gorce
gryficki	gryfice
wschowianka	wschowa
bartoszyczanin	bartoszyce
augustianin	augustów
garwolinianin	garwolin
kartuski	kartuzy
bytowski	bytów
zgierzanka	zgierz
krakowiak	kraków
podchorzowski	chorzów
podsanocki	sanok
buskowianin	busko-zdrój
lublinianka	lublin
biskupstwo	biskupiec
przemkowianin	przemków
krapkowiczanka	krapkowice
piotrkowianin	piotrków trybunalski
katowicki	katowice
bytomski	bytom
podradomski	radom
pilski	piła
zgorzelczanin	zgorzelec
warszawistka	warszawa
bystrzycki	bystrzyca kłodzka
chrzanowski	chrzanów
goleniowianin	goleniów
wielunianin	wieluń
tyszanin	tychy
oborniczanin	oborniki śląskie
boguszowianin	boguszów-gorce
lubartowianka	lubartów
opolanka	opole
konecczanka	końskie
bielskobialski	bielsko-biała
sosnowiczanka	sosnowiec
buszczanin	busko-zdrój
rudzianka	ruda Śląska
turczynka	turek
chojniczanin	chojnice
bolkowianin	bolków
lubartowski	lubartów
koszalinianin	koszalin
star	starachowice
podsiedlecki	siedlce
kaliszowa	kalisz
kartuzianka	kartuzy
kaliszowy	kalisz
turkijski	turek
ustczanka	ustka
strzegomianka	strzegom
sandomierzanin	sandomierz
mysz	myszków
olsztynianin	olsztyn
ustecki	ustka
zdzieszowicki	zdzieszowice
sanocki	sanok
chojnicki	chojnice
wieruszowianka	wieruszów
brzegowianin	brzeg
lubonianka	luboń
jaworznicki	jaworzno